エクセルファイル <A> を表に読み込む	pd . read_excel ( <A> )	kind = pd . read_excel ( <A> )
<A> をインデックスで値が小さい順に並び替えた結果を <A> に代入する	<A> = <A> . sort_index ( )	sort_index = <A> . sort_index ( )
データフレーム <A> の欠損がある行を削除された結果で置き換える	<A> = <A> . dropna ( )	dropna = <A> . dropna ( )
データフレーム <A> をファイル <B> というファイル名で CSV ファイルに出力する	<A> . to_csv ( <B> )	to_csv <A> . to_csv ( <B> )
<B> データフレーム全体をインデックスを軸に昇順でソートして、 <A> に代入する	<A> = <B> . sort_index ( )	markerfacecolor = <B> . sort_index ( )
ある <B> を <A> の中に未入力の値とされた結果を <A> とする	<A> = <A> . replace ( <B> , np . nan )	nan <A> = <A> . replace ( <B> , np . nan )
データフレーム <A> の欠損値を <B> に変える	<A> . fillna ( <B> )	plt . fillna ( <A> , <B> )
<B> データフレームをインデックスどおりに昇順でソートした結果を <A> に代入する	<A> = <B> . sort_index ( )	sort_index <A> = <B> . sort_index ( )
打点の輪郭線の幅は <A> を適用する	markeredgewidth = <A>	end = <A>
データフレーム <A> の <B> を NaN に置き換え、置き換える	<A> = <A> . replace ( <B> , np . nan )	np . replace ( <A> , <B> , np . nan , inplace = True )
<B> から <C> に <A> の列名をリネームし、再代入する	<A> = <A> . rename ( columns = { <B> : <C> } )	} = <A> . rename ( columns = { <B> : <C> } )
データフレーム <A> の中の未記入の値を落として、再代入する	<A> = <A> . dropna ( )	nan = <A> . dropna ( )
棒グラフの位置を真ん中として <A> と <B> の鉛直棒グラフを描写する	plt . bar ( <A> , <B> , align = 'center' )	bar plt . bar ( <A> , <B> , align = 'center' )
列番号 <B> をインデックスとデータ <A> を表データに格納する	pd . read_csv ( <A> , index_col = <B> )	set_index = pd . read_csv ( <A> , index_col = <B> )
<A> 内に存在する <B> を欠損にした結果で置き換える	<A> = <A> . replace ( <B> , np . nan )	np . replace ( <A> , <B> , np . nan , inplace = True )
<A> データフレームをインデックスに基づき昇順でソートする	<A> . sort_index ( )	pd . sort_index ( )
<A> の <B> を欠損値で置換して、書き換える	<A> . replace ( <B> , np . nan , inplace = True )	replace <A> . replace ( <B> , np . nan , inplace = True )
データ <A> を <B> 区切りで読む	pd . read_csv ( <A> , sep = <B> )	<A> . pd . read_csv ( <B> , sep = <B> )
<A> データフレームを <B> ファイルという名前で保存する	<A> . to_csv ( <B> )	to_csv <A> . to_csv ( <B> )
存在する <B> を <A> 内に欠損で補って、 <A> に代入する	<A> = <A> . replace ( <B> , np . nan )	nan <A> = <A> . replace ( <B> , np . nan )
<A> データフレーム内のそれぞれのカラムにある <B> の個数の合計	<A> . isin ( [ <B> ] ) . sum ( )	isin <A> = <B> . isin ( [ <C> ] ) . sum ( )
データフレーム <A> 全体をインデックスで昇順にソートした結果を再代入する	<A> = <A> . sort_index ( )	sort_index = <A> . sort_index ( )
重複する最後の行を残してデータフレーム <A> 中の重複している行を消す	<A> . drop_duplicates ( keep = False )	<B> <A> . drop_duplicates ( keep = False )
データフレーム <A> 中のそれぞれのコラムにある <B> の数の合計	<A> . isin ( [ <B> ] ) . sum ( )	isin <A> = <B> . isin ( [ <C> ] ) . sum ( )
<B> データフレーム中の <C> コラムの重複する行を消した結果を <A> に代入する	<A> = <B> . drop_duplicates ( subset = <C> )	markeredgecolor = <B> . drop_duplicates ( subset = <C> )
<A> 内の <B> に重複がある行をドロップした結果でインプレースする	<A> . drop_duplicates ( subset = <B> , inplace = True )	drop_duplicates = <A> . drop_duplicates ( subset = <B> , inplace = True )
<A> データフレーム中の <B> コラムのダブる行を落とし、置き換える	<A> = <A> . drop_duplicates ( subset = <B> )	<B> <A> = <A> . drop_duplicates ( subset = <B> )
<A> データフレームを <B> コラムと <C> 列が降順になるようにソートされた結果で置き換える	<A> . sort_values ( [ <B> , <C> ] , ascending = False , inplace = True )	flush = <A> . sort_values ( [ <B> , <C> ] , ascending = False , inplace = True )
データフレーム <A> のカラム名を <B> から <C> にリネームした結果で置き換える	<A> = <A> . rename ( columns = { <B> : <C> } )	flush = <A> . rename ( columns = { <B> : <C> } , inplace = True )
<B> という名前のエクセルファイルとして <A> をセーブする	<A> . to_excel ( <B> )	to_excel = <A> . to_excel ( <B> )
エクセルファイル <B> の <C> 番目のシートから表データを読み込み、 <A> にする	<A> = pd . read_excel ( <B> , sheet_name = <C> )	markerfacecolor = pd . read_excel ( <B> , sheet_name = <C> )
<A> データフレームの <B> カラムと <C> コラムと <D> カラムを選ぶ	<A> [ [ <B> , <C> , <D> ] ]	sns . pairplot ( <A> [ [ <B> , <C> , <D> ] ] )
<B> の列名を <C> から <D> に変え、 <A> にする	<A> = <B> . rename ( columns = { <C> : <D> } )	} = <B> . rename ( columns = { <C> : <D> } )
ピボット操作で <A> データフレームの列を行に変更する	<A> . stack ( )	alpha = <A> . stack ( )
データフレーム <B> の <C> を欠損値とし、 <A> にする	<A> = <B> . replace ( <C> , np . nan )	<B> <A> = <B> . replace ( <C> , np . nan )
データフレーム <A> 中にある <B> を NaN で置き換え、 <A> とする	<A> = <A> . replace ( <B> , np . nan )	nan <A> = <A> . replace ( <B> , np . nan )
要素数が等しくなるようにデータフレーム <B> のコラム <C> を区間の数を <D> として分割し、 <A> に代入する	<A> = pd . qcut ( <B> [ <C> ] , <D> )	marker = pd . qcut ( <B> [ <C> ] , <D> )
<A> の <B> をグループ化したときの値ごとのデータ件数を算出する	<A> . groupby ( <B> ) . size ( )	<B> <A> [ <B> ] . size ( )
カラム <B> と列 <C> を元にデータフレーム <A> を値が大きい順でソートし、再代入する	<A> = <A> . sort_values ( [ <B> , <C> ] , ascending = False )	[ <A> = <A> . sort_values ( [ <B> , <C> ] , ascending = False )
データフレーム <A> をエクセルファイル <B> に付ける	<A> . to_excel ( <B> )	to_excel <A> . to_excel ( <B> )
垂直棒グラフを用いる	kind = 'bar'	align = 'bar'
列番号 <B> をインデックスとセットしてデータ <A> から表データを読む	pd . read_csv ( <A> , index_col = <B> )	<A> . pd . read_csv ( <B> , index_col = <C> )
エンコーディングをシフト JIS で、データ <A> を読む	pd . read_csv ( <A> , encoding = 'shift_jis' )	encoding = pd . read_csv ( <A> , encoding = 'shift_jis' )
<A> 全体を <B> と <C> を元に逆順でソートして、再代入する	<A> = <A> . sort_values ( [ <B> , <C> ] , ascending = False )	[ <A> = <A> . sort_values ( [ <B> , <C> ] , ascending = False )
<A> データフレームの <B> コラムと <C> をドロップされた結果を <A> とする	<A> = <A> . drop ( [ <B> , <C> ] , axis = 1 )	plt . plot ( <A> , <B> , axis = 1 , inplace = True )
<B> データフレームの列名を <E> から <F> に <C> から <D> にリネームして、 <A> にする	<A> = <B> . rename ( columns = { <C> : <D> , <E> : <F> } )	<A> = <B> . drop_duplicates ( columns = { <C> : <D> , <E> : <F> } )
ある <B> をデータフレーム <A> の中に未入力の値に置き換えた結果を <A> とする	<A> = <A> . replace ( <B> , np . nan )	nan <A> = <A> . replace ( <B> , np . nan )
データフレーム <A> 内に存在する <B> を欠損とされた結果でインプレースする	<A> . replace ( <B> , np . nan , inplace = True )	replace <A> . replace ( <B> , np . nan , inplace = True )
<A> 内の重複要素がある行をドロップして、置き換える	<A> . drop_duplicates ( inplace = True )	kind = <A> . drop_duplicates ( )
データフレーム <A> をカラム <B> と列 <C> を軸に逆順でソートして、再代入する	<A> = <A> . sort_values ( [ <B> , <C> ] , ascending = False )	[ <A> = <A> . sort_values ( [ <B> , <C> ] , ascending = False )
<A> データフレーム内の <B> を欠損に変え欠損が存在する行を削除し、置き換える	<A> = <A> . replace ( <B> , np . nan ) . dropna ( )	<A> . replace ( <B> , np . nan ) . dropna ( inplace = True )
<A> データフレーム中に重複があるかどうか確認する	<A> . duplicated ( )	duplicated <A> . duplicated ( )
<A> データフレームをインデックスで並び替え、書き換える	<A> . sort_index ( inplace = True )	sort_index = <A> . sort_index ( )
<B> の <C> をインデックス、 <D> をカラムとしたピボットテーブルを作成して、 <A> に代入する	<A> = <B> . pivot_table ( index = <C> , columns = <D> )	plt . plot ( <A> , <B> , left_index = True , right_on = <C> )
データフレーム <A> の <B> を欠損にして、 <A> にする	<A> = <A> . replace ( <B> , np . nan )	nan <A> = <A> . replace ( <B> , np . nan )
<A> データフレームの列の名前を <B> から <C> に <D> から <E> にリネームした結果でインプレースする	<A> . rename ( columns = { <B> : <C> , <D> : <E> } , inplace = True )	<B> <A> . rename ( columns = { <C> : <D> , <E> : <F> } , inplace = True )
エクセルファイル <A> の <B> シート名を読み込む	pd . read_excel ( <A> , sheet_name = <B> )	sheet_name = pd . read_excel ( <A> , sheet_name = <B> )
データ <B> からデータフレームで読み、 <A> に代入する	<A> = pd . read_csv ( <B> )	markerfacecolor = pd . read_csv ( <A> , <B> )
<B> から <C> に <A> データフレームのカラム名を変えて、置き換える	<A> . rename ( columns = { <B> : <C> } , inplace = True )	<B> <A> . rename ( columns = { <B> : <C> } , inplace = True )
<A> 内に存在する <B> を欠損で置換された結果を <A> に代入する	<A> = <A> . replace ( <B> , np . nan )	nan <A> = <A> . replace ( <B> , np . nan )
<B> から <C> にデータフレーム <A> のカラム名を変え、置き換える	<A> = <A> . rename ( columns = { <B> : <C> } )	<B> <A> . rename ( columns = { <B> : <C> } , inplace = True )
<B> データフレームをインデックスを軸に小さい順にソートした結果を <A> に代入する	<A> = <B> . sort_index ( )	markerfacecolor = <B> . sort_index ( )
<A> データフレームの <B> カラムを年月日の形式にする	pd . to_datetime ( <A> [ <B> ] )	range = ( <A> [ <B> ] )
インデックスを元に <A> データフレーム全体を小さい順にソートした結果を <A> に代入する	<A> = <A> . sort_index ( )	sort_index = <A> . sort_index ( )
日付の形にデータフレーム <A> のカラム <B> をする	pd . to_datetime ( <A> [ <B> ] )	range = ( <A> [ <B> ] )
<A> の中にある <B> を未入力の値で埋めた結果を <A> にする	<A> = <A> . replace ( <B> , np . nan )	nan <A> = <A> . replace ( <B> , np . nan )
<B> と <C> を元に <A> 全体を降順でソートした結果で置き換える	<A> = <A> . sort_values ( [ <B> , <C> ] , ascending = False )	flush = <A> . sort_values ( [ <B> , <C> ] , ascending = False , inplace = True )
データフレーム <A> の行の重複を検出する	<A> . duplicated ( )	duplicated <A> . duplicated ( )
<B> から <C> にデータフレーム <A> の列の名前を変更する	<A> . rename ( columns = { <B> : <C> } )	} = <B> . rename ( columns = { <C> : <D> } )
存在する <B> をデータフレーム <A> 中に NaN に置換し、 <A> に代入する	<A> = <A> . replace ( <B> , np . nan )	nan <A> = <A> . replace ( <B> , np . nan )
ファイル <B> という名前の CSV としてデータフレーム <A> を出力する	<A> . to_csv ( <B> )	to_csv <A> . to_csv ( <B> )
<B> という名前のエクセルファイルの <C> を表として読み込まれた結果を <A> にする	<A> = pd . read_excel ( <B> , sheet_name = <C> )	markerfacecolor = pd . read_excel ( <B> , sheet_name = <C> )
<A> を <B> をもとに昇順でソートする	<A> . sort_values ( <B> )	markerfacecolor = <A> . sort_values ( <B> )
<B> に <A> をセーブする	<A> . to_csv ( <B> )	range = <A> . to_csv ( <B> )
<B> データフレーム中の NaN を含む行を消した結果を <A> に代入する	<A> = <B> . dropna ( )	dropna <A> = <B> . dropna ( )
<A> データフレーム中の <B> を NaN に変え NaN が存在する行を消す	<A> . replace ( <B> , np . nan ) . dropna ( )	replace <A> . replace ( <B> , np . nan ) . dropna ( )
ある <B> をデータフレーム <A> の中に未入力の値にした結果を再代入する	<A> = <A> . replace ( <B> , np . nan )	nan <A> = <A> . replace ( <B> , np . nan )
列番号 <B> をインデックスにセットして <A> を格納する	pd . read_csv ( <A> , index_col = <B> )	index_col pd . read_csv ( <A> , index_col = <B> , index_col = <B> )
<A> の中の未入力の値がある行を落とし、置き換える	<A> = <A> . dropna ( )	dropna = <A> . dropna ( )
y 軸を <A> とした <B> の横方向の棒グラフを表示する	plt . barh ( <A> , <B> )	plt . barh ( <A> , <B> , align = 'center' )
<B> という名前のエクセルファイルの <C> シート名をデータフレームとして読み、 <A> にする	<A> = pd . read_excel ( <B> , sheet_name = <C> )	markerfacecolor = pd . read_excel ( <B> , sheet_name = <C> )
データフレーム <A> の中の未記入の値を <B> で置き換え、置き換える	<A> = <A> . fillna ( <B> )	<B> <A> . fillna ( <B> , inplace = True )
データフレーム <A> の中の未入力の値を <B> で埋められた結果で置き換える	<A> = <A> . fillna ( <B> )	flush = <A> . fillna ( <B> )
データフレーム <A> をインデックスどおりに昇順でソートして、置き換える	<A> . sort_index ( inplace = True )	kind = <A> . sort_index ( )
<A> と <B> と <C> を箱ひげ図にプロットする	plt . boxplot ( [ <A> , <B> , <C> ] )	kind = pd . boxplot ( [ <B> , <C> ] )
データフレーム <A> 中の未記入の値を <B> とした結果を再代入する	<A> = <A> . fillna ( <B> )	plt . fillna ( <A> , <B> , inplace = True )
<A> の中にある <B> を未入力の値で置き換え、 <A> にする	<A> = <A> . replace ( <B> , np . nan )	nan <A> = <A> . replace ( <B> , np . nan )
一番左の列をインデックスとして、 <A> を表データとして読む	pd . read_csv ( <A> , index_col = 0 )	0 = pd . read_csv ( <A> , index_col = 0 )
<B> データフレームの <C> を未入力の値で埋められた結果を <A> に代入する	<A> = <B> . replace ( <C> , np . nan )	<B> <A> = <B> . replace ( <C> , np . nan )
<B> の <C> をビンに含まれる個数が等しくなるようにビン数を <D> として分割された結果を <A> に代入する	<A> = pd . qcut ( <B> [ <C> ] , <D> )	marker = pd . qcut ( <B> [ <C> ] , <D> )
表データとして <B> をカンマ区切りで読み込み、 <A> にする	<A> = pd . read_csv ( <B> , sep = ',' )	markerfacecolor = pd . read_csv ( <A> , sep = ',' )
<B> から表で読み、 <A> にする	<A> = pd . read_csv ( <B> )	markerfacecolor = pd . read_csv ( <A> , <B> )
列番号 <B> をインデックスとセットして <A> から表を読む	pd . read_csv ( <A> , index_col = <B> )	<A> . pd . read_csv ( <B> , index_col = <C> )
<A> データフレーム内の欠損を含む行を削除した結果を <A> にする	<A> = <A> . dropna ( )	marker = <A> . dropna ( )
目印の色は青を適用する	markerfacecolor = 'blue'	markeredgecolor = 'blue'
<B> の中の未記入の値を <C> で置き換えられた結果を <A> に代入する	<A> = <B> . fillna ( <C> )	markeredgecolor = <B> . fillna ( <C> )
先頭の列をインデックスと設定して、データ <A> をデータフレームとして読む	pd . read_csv ( <A> , index_col = 0 )	start = pd . read_csv ( <A> , index_col = 0 )
<B> データフレームの数値じゃないデータを数値データに変換し、 <A> にする	<A> = pd . get_dummies ( <B> )	markerfacecolor = pd . get_dummies ( <A> , <B> )
<B> の中の未入力の値を <C> に置き換え、 <A> に代入する	<A> = <B> . fillna ( <C> )	markeredgecolor = <B> . fillna ( <C> )
<A> を <B> という名前の CSV ファイルとして保存する	<A> . to_csv ( <B> )	to_csv <A> . to_csv ( <B> )
区間を <D> としてデータフレーム <B> のコラム <C> をビンに含まれる個数が等しくなるように分割した結果を <A> とする	<A> = pd . qcut ( <B> [ <C> ] , <D> )	marker = pd . qcut ( <B> [ <C> ] , <D> )
データフレーム <A> をインデックスにそって昇順でソートし、書き換える	<A> . sort_index ( inplace = True )	sort_index = <A> . sort_index ( )
表を <A> からカンマ区切りで読み込む	pd . read_csv ( <A> , sep = ',' )	',' = pd . read_csv ( <A> , sep = ',' )
エクセルファイル <B> に <A> データフレームを描画する	<A> . to_excel ( <B> )	to_excel = <A> . to_excel ( <B> )
<A> データフレームの <B> コラムの名前を <C> に <D> 列の名前を <E> にリネームし、インプレースする	<A> . rename ( columns = { <B> : <C> , <D> : <E> } , inplace = True )	<B> <A> . rename ( columns = { <C> : <D> , <E> : <F> } , inplace = True )
データフレーム <A> のインデックスをリセットし、置き換える	<A> . reset_index ( inplace = True )	kind = <A> . reset_index ( )
インデックスを元に <A> データフレームを小さい順でソートした結果で書き換える	<A> . sort_index ( inplace = True )	sort_index = <A> . sort_index ( )
<A> データをタブ区切りで読み込む	pd . read_csv ( <A> , sep = '\t' )	kind = pd . read_csv ( <A> , sep = '\t' )
<B> と <C> を軸に <A> 全体を降順でソートし、置き換える	<A> = <A> . sort_values ( [ <B> , <C> ] , ascending = False )	flush = <A> . sort_values ( [ <B> , <C> ] , ascending = False , inplace = True )
エクセルファイル <B> のシート名 <C> を表として読み込んで、 <A> にする	<A> = pd . read_excel ( <B> , sheet_name = <C> )	markerfacecolor = pd . read_excel ( <B> , sheet_name = <C> )
<A> の中のそれぞれの列にある <B> の数の合計値をチェックする	<A> . isin ( [ <B> ] ) . sum ( )	isin <A> = <B> . isin ( [ <C> ] ) . sum ( )
<A> と <B> を折れ線グラフで表示する	plt . plot ( <A> , <B> )	<A> . to_csv ( <B> )
グラフの x 軸の軸の名前を <A> にする	plt . xlabel ( <A> )	<A> = pd . xlabel ( <B> )
データフレーム <A> のカラム <B> とカラム <C> とカラム <D> についての箱ひげ図をプロットする	plt . boxplot ( [ <A> [ <B> ] , <A> [ <C> ] , <A> [ <D> ] ] )	pd . qcut ( <A> [ <B> ] , <C> , label = <D> )
<B> の <C> をビンに含まれる個数が等しくなるように区間を <D> として分割された結果を <A> に代入する	<A> = pd . qcut ( <B> [ <C> ] , <D> )	marker = pd . qcut ( <B> [ <C> ] , <D> )
<A> の中にある <B> を未入力の値で置き換えて、インプレースする	<A> . replace ( <B> , np . nan , inplace = True )	replace <A> . replace ( <B> , np . nan , inplace = True )
表データを <B> から読んだ結果を <A> にする	<A> = pd . read_csv ( <B> )	markerfacecolor = pd . read_csv ( <B> )
インデックスを元に <A> データフレームを小さい方からソートした結果を再代入する	<A> = <A> . sort_index ( )	sort_index = <A> . sort_index ( )
<B> というファイル名でエクセルファイルに <A> データフレームを表示する	<A> . to_excel ( <B> )	markerfacecolor = <A> . to_excel ( <B> )
<A> データフレームの <B> コラムをビンの数を <C> 、ビンのラベルを整数値として分割する	pd . cut ( <A> [ <B> ] , <C> , label = False )	<A> . pd . cut ( <B> [ <C> ] , <D> , label = False )
<A> 内にいくつ欠損がどの程度あるのか数える	<A> . isnull ( ) . sum ( )	isnull <A> . isnull ( ) . sum ( )
文字コードがシフト JIS のファイル <A> を読み込む	pd . read_csv ( <A> , encoding = 'shift_jis' )	start = pd . read_csv ( <A> , encoding = 'shift_jis' )
インデックスを元にデータフレーム <A> 全体を小さい順でソートして、インプレースする	<A> . sort_index ( inplace = True )	sort_index = <A> . sort_index ( )
真ん中として <A> と <B> の縦向き棒グラフを棒グラフの位置を表示する	plt . bar ( <A> , <B> , align = 'center' )	bar plt . bar ( <A> , <B> , align = 'center' )
データフレーム <A> 中に存在する <B> を NaN で埋め、 <A> に代入する	<A> = <A> . replace ( <B> , np . nan )	nan <A> = <A> . replace ( <B> , np . nan )
年月日の形式にデータフレーム <A> のカラム <B> を変換する	pd . to_datetime ( <A> [ <B> ] )	range = ( <A> [ <B> ] )
<B> データからデータフレームをタブ区切りで読み込んで、 <A> に代入する	<A> = pd . read_csv ( <B> , sep = '\t' )	plt . read_csv ( <A> , sep = '\t' )
密度推定図を用いる	kind = 'density'	byteorder = 'density'
エクセルファイル <B> の <C> シート名から表データを読み込んで、 <A> とする	<A> = pd . read_excel ( <B> , sheet_name = <C> )	markerfacecolor = pd . read_excel ( <A> , sheet_name = <B> )
<A> の <B> のバリュー	<A> [ <B> ] . values	[ <A> [ <B> ] . values
列番号 <B> をインデックスにデータ <A> を格納する	pd . read_csv ( <A> , index_col = <B> )	set_index = pd . read_csv ( <A> , index_col = <B> )
分割数を <C> として <A> データフレームの <B> コラムを分割する	pd . cut ( <A> [ <B> ] , <C> )	<A> = pd . cut ( <B> [ <C> ] , <D> )
<A> データフレームの <B> を欠損値に置換して、書き換える	<A> . replace ( <B> , np . nan , inplace = True )	replace <A> . replace ( <B> , np . nan , inplace = True )
データフレーム <B> のカラム <C> の曜日の数値型を <A> にする	<A> = <B> [ <C> ] . dt . dayofweek	<A> = <B> [ <C> ] . dt . weekday_name
データフレーム <A> の <B> を NaN に置換し、 <A> にする	<A> = <A> . replace ( <B> , np . nan )	nan <A> = <A> . replace ( <B> , np . nan )
<A> データフレームの重複行を検出を調べる	<A> . duplicated ( )	duplicated <A> . duplicated ( )
<A> 全体をインデックスを元に昇順でソートした結果を <A> にする	<A> = <A> . sort_index ( )	sort_index = <A> . sort_index ( <A> . mean ( )
<B> から <C> に <A> のカラム名を変更した結果で置き換える	<A> . rename ( columns = { <B> : <C> } , inplace = True )	<B> <A> . rename ( columns = { <B> : <C> } , inplace = True )
<A> データフレームを <B> カラムと <C> 列で値が大きい順にソートし、 <A> にする	<A> = <A> . sort_values ( [ <B> , <C> ] , ascending = False )	[ <A> = <A> . sort_values ( [ <B> , <C> ] , ascending = False )
<A> データフレームを <B> ファイルという名前で CSV として出力する	<A> . to_csv ( <B> )	markerfacecolor = <A> . to_csv ( <B> )
<A> データフレーム全体をインデックスを元に小さい順にソートした結果を <A> にする	<A> = <A> . sort_index ( )	sort_index = <A> . sort_index ( )
エクセルファイル <A> をデータフレームにする	pd . read_excel ( <A> )	start = pd . read_excel ( <A> )
<A> データフレーム中の未記入の値を <A> データフレームの平均で補う	<A> . fillna ( <A> . mean ( ) )	<A> . groupby ( [ <B> , <C> ] ) [ <D> ] . mean ( )
<A> を区関数 <B> の度数分布図を用いて表示する	plt . hist ( <A> , bins = <B> )	<A> = plt . hist ( <B> , bins = <C> )
<A> データフレームの中の <B> コラムに重複がある行を取り除く	<A> . drop_duplicates ( subset = <B> )	<A> = <B> . drop_duplicates ( subset = <C> )
x 座標の軸名を <A> に変更する	plt . xlabel ( <A> )	pd . xlabel ( <A> )
<B> データフレームの <C> コラムについてダミー変数を作った結果を <A> とする	<A> = pd . get_dummies ( <B> [ <C> ] )	autopct = pd . get_dummies ( <B> [ <C> ] )
ある行をデータフレーム <A> の中の未入力の値が落とす	<A> . dropna ( )	pd . dropna ( )
線グラフを水色で表示する	color = 'cyan'	markerfacecolor = 'cyan'
データフレーム <B> の中にある <C> を未記入の値で補って、 <A> に代入する	<A> = <B> . replace ( <C> , np . nan )	<B> <A> = <B> . replace ( <C> , np . nan )
エクセルファイル <A> からデータフレームを読み込む	pd . read_excel ( <A> )	kind = pd . read_excel ( <A> )
<A> を箱ひげ図にする	plt . boxplot ( <A> )	<A> . sort_index ( )
<B> ファイルに <A> データフレームをセーブする	<A> . to_csv ( <B> )	to_csv <A> . to_csv ( <B> )
データフレーム <A> のデータを表示する	<A> . info ( )	pd . info ( <A> )
<B> データフレーム内の重複要素がある行をドロップし、 <A> とする	<A> = <B> . drop_duplicates ( )	mode = <B> . drop_duplicates ( )
左側の表に合わせて <B> データフレームと <C> データフレームをマージした結果を <A> にする	<A> = pd . merge ( <B> , <C> , how = 'left' )	markerfacecolor = pd . merge ( <B> , <C> , how = 'left' )
<A> データフレームの <B> コラムを区間を <C> として分割する	pd . cut ( <A> [ <B> ] , <C> )	<A> = pd . cut ( <B> [ <C> ] , <D> )
<A> の <B> を欠損に置換された結果を <A> とする	<A> = <A> . replace ( <B> , np . nan )	nan <A> = <A> . replace ( <B> , np . nan )
<A> 内の <B> の重複した行をドロップし、 <A> とする	<A> = <A> . drop_duplicates ( subset = <B> )	markerfacecolor = <A> . drop_duplicates ( subset = <B> )
エクセルファイル <B> を表データに読み込んで、 <A> とする	<A> = pd . read_excel ( <B> )	markerfacecolor = pd . read_excel ( <A> , <B> )
データフレーム <A> のコラム <B> をインデックスとしてされた結果を <A> にする	<A> = <A> . set_index ( <B> )	plt . set_index ( <A> , <B> , align = True )
データフレーム <A> の中の未記入の値を <B> として、置き換える	<A> . fillna ( <B> , inplace = True )	<B> <A> . fillna ( <B> , inplace = True )
グラフを青色で表示する	color = 'blue'	markeredgecolor = 'blue'
データフレーム <A> のコラム <B> の名前を <C> に <E> に列 <D> の名前をリネームした結果で置き換える	<A> = <A> . rename ( columns = { <B> : <C> , <D> : <E> } )	: <A> . rename ( columns = { <B> : <C> , <D> : <E> } , inplace = True )
<A> の NaN を <B> にし、 <A> にする	<A> = <A> . fillna ( <B> )	plt . fillna ( <A> , <B> , inplace = True )
<B> 全体をインデックスを軸に昇順でソートした結果を <A> にする	<A> = <B> . sort_index ( )	sort_index <A> = <B> . sort_index ( )
最大行数を <A> に設定する	pd . set_option ( 'display.max_rows' , <A> )	start = pd . set_option ( 'display.max_rows' , <A> )
<B> データフレームの中にある <C> を未入力の値として、 <A> に代入する	<A> = <B> . replace ( <C> , np . nan )	<B> <A> = <B> . replace ( <C> , np . nan )
目印は四角形を適用する	marker = 's'	sheet_name = 's'
<A> から表を <B> 区切りで読む	pd . read_csv ( <A> , sep = <B> )	<A> . pd . read_csv ( <B> , sep = <B> )
エクセルファイル <A> のシート名 <B> を表データにする	pd . read_excel ( <A> , sheet_name = <B> )	sheet_name = <A> . pd . read_excel ( <B> )
<A> の <B> を NaN に置き換えて、インプレースする	<A> . replace ( <B> , np . nan , inplace = True )	replace <A> . replace ( <B> , np . nan , inplace = True )
<A> の未入力の値を <B> にする	<A> . fillna ( <B> )	plt . fillna ( <A> [ <B> ] )
インデックスを軸にデータフレーム <A> 全体を昇順でソートし、 <A> に代入する	<A> = <A> . sort_index ( )	sort_index = <A> . sort_index ( )
×のマーカーの種類を使う	marker = 'x'	to_excel = 'x'
<A> 中のインデックスが <B> の行	<A> . loc [ <B> ]	<A> . set_index ( <B> )
線の種類は点線を適用する	linestyle = 'dotted'	colormap = 'dotted'
<A> の度数分布図を <B> から <C> の区間で表示する	plt . hist ( <A> , range = ( <B> , <C> ) )	<A> . rename ( columns = { <B> : <C> } , inplace = True )
<B> から <C> にデータフレーム <A> のインデックス名をリネームした結果で置き換える	<A> . rename ( index = { <B> : <C> } , inplace = True )	flush = <A> . rename ( index = { <B> : <C> } , inplace = True )
ヘッダーの表示を右寄せに変更する	pd . set_option ( 'colheader_justify' , 'right' )	'colheader_justify' = pd . set_option ( 'colheader_justify' , 'right' )
データフレーム <A> の中にある <B> を未記入の値とした結果を再代入する	<A> = <A> . replace ( <B> , np . nan )	nan <A> = <A> . replace ( <B> , np . nan )
<A> の <B> 行目を消す	<A> . drop ( <B> )	plt . drop ( <A> , <B> )
数値で扱えるように <B> データフレームの数値以外のデータを処理して、 <A> とする	<A> = pd . get_dummies ( <B> )	markerfacecolor = pd . get_dummies ( <A> , <B> )
<B> 中の <C> を NaN に変え NaN が存在する行を消した結果を <A> にする	<A> = <B> . replace ( <C> , np . nan ) . dropna ( )	markeredgecolor = <B> . dropna ( )
打点の色は赤を使う	markerfacecolor = 'red'	markeredgecolor = 'red'
<A> と <B> を <C> とラベル付けされたグラフで表示する	plt . plot ( <A> , <B> , label = <C> )	<A> = pd . plot ( <B> , <C> , label = False )
データフレーム <A> のカラム <B> を度数分布図で表示する	plt . hist ( <A> [ <B> ] )	mode = plt . hist ( <A> [ <B> ] )
<A> と <B> の折れ線グラフを <C> で表示する	plt . plot ( <A> , <B> , color = <C> )	<A> = plt . plot ( <B> , color = <C> )
<B> データをデータフレームに格納された結果を <A> にする	<A> = pd . read_csv ( <B> )	<A> = pd . merge ( <B> )
<A> データフレーム中の <B> を欠損に置換し欠損が存在する行を削除して、置き換える	<A> = <A> . replace ( <B> , np . nan ) . dropna ( )	<A> . replace ( <B> , np . nan ) . dropna ( inplace = True )
データフレーム <A> のコラム <B> の名前を <C> に <E> に列 <D> の名前をリネームし、インプレースする	<A> . rename ( columns = { <B> : <C> , <D> : <E> } , inplace = True )	<B> <A> . rename ( columns = { <C> : <D> , <E> : <F> } , inplace = True )
<A> 中にある <B> を NaN に置き換えて、 <A> に代入する	<A> = <A> . replace ( <B> , np . nan )	nan <A> = <A> . replace ( <B> , np . nan )
データフレーム <A> の <B> を未記入の値で埋められた結果を <A> にする	<A> = <A> . replace ( <B> , np . nan )	nan <A> = <A> . replace ( <B> , np . nan )
棒グラフを用いる	kind = 'bar'	flush = 'bar'
<C> 番目の列をインデックスと設定して、 <B> データを表データとして読み、 <A> に代入する	<A> = pd . read_csv ( <B> , index_col = <C> )	markerfacecolor = pd . read_csv ( <A> , index_col = <B> )
<A> データフレームの <B> を未記入の値にし、インプレースする	<A> . replace ( <B> , np . nan , inplace = True )	replace <A> . replace ( <B> , np . nan , inplace = True )
ビンの数を <C> 、ビンのラベルを整数値としてデータフレーム <A> のコラム <B> を分割する	pd . cut ( <A> [ <B> ] , <C> , label = False )	False = pd . cut ( <A> [ <B> ] , <C> , label = False )
<B> データフレームの <C> カラムの分を <A> とする	<A> = <B> [ <C> ] . dt . minute	<A> = <B> [ <C> ] . dt . weekday_name
エクセルファイル <B> のシート名 <C> を読み込み、データフレームにした結果を <A> に代入する	<A> = pd . read_excel ( <B> , sheet_name = <C> )	markerfacecolor = pd . read_excel ( <B> , sheet_name = <C> )
<A> データフレームの <B> カラムをインデックスにして、 <A> に代入する	<A> = <A> . set_index ( <B> )	set_index = <A> . set_index ( <B> )
<B> データから表データで読み込まれた結果を <A> に代入する	<A> = pd . read_csv ( <B> )	markerfacecolor = pd . read_csv ( <A> , <B> )
存在する <B> をデータフレーム <A> 中に NaN で置換して、書き換える	<A> . replace ( <B> , np . nan , inplace = True )	replace <A> . replace ( <B> , np . nan , inplace = True )
データフレーム <A> 内の欠損値をドロップし、再代入する	<A> = <A> . dropna ( )	nan = <A> . dropna ( )
エクセル <A> を表に読み込む	pd . read_excel ( <A> )	kind = pd . read_excel ( <A> )
データフレーム <B> をインデックスどおりに昇順でソートした結果を <A> にする	<A> = <B> . sort_index ( )	sort_index <A> = <B> . sort_index ( )
マーカーの色を黄色とする	markerfacecolor = 'yellow'	marker = 'yellow'
エクセルファイル <A> の <B> シート名を読み込み、表とする	pd . read_excel ( <A> , sheet_name = <B> )	<A> . pd . read_excel ( <B> , sheet_name = <B> )
<B> から <C> に <A> データフレームの列の名前を変えた結果でインプレースする	<A> . rename ( columns = { <B> : <C> } , inplace = True )	<B> <A> . rename ( columns = { <C> : <D> } , inplace = True )
<A> の中のダブっている行を取り除き、置き換える	<A> = <A> . drop_duplicates ( )	= <A> = <A> . drop_duplicates ( )
データフレーム <A> をコラム <B> と列 <C> が値の大きい順になるようにソートして、 <A> に代入する	<A> = <A> . sort_values ( [ <B> , <C> ] , ascending = False )	[ <A> = <A> . sort_values ( [ <B> , <C> ] , ascending = False )
<A> データフレームをインデックスを元にソートされた結果で置き換える	<A> = <A> . sort_index ( )	kind = <A> . sort_index ( )
<B> の <C> を区関数を <D> として分割して、 <A> に代入する	<A> = pd . cut ( <B> [ <C> ] , <D> )	[ <A> = pd . cut ( <B> [ <C> ] , <D> )
<A> の列名を <D> から <E> に <B> から <C> にリネームされた結果を再代入する	<A> = <A> . rename ( columns = { <B> : <C> , <D> : <E> } )	<B> <A> . rename ( columns = { <B> : <C> , <D> : <E> } , inplace = True )
<A> の中にある <B> を未記入の値で補った結果で書き換える	<A> . replace ( <B> , np . nan , inplace = True )	replace <A> . replace ( <B> , np . nan , inplace = True )
<A> データフレームをインデックスを軸に小さい順にソートした結果を再代入する	<A> = <A> . sort_index ( )	sort_index = <A> . sort_index ( )
<A> データフレームの <B> を欠損とした結果を再代入する	<A> = <A> . replace ( <B> , np . nan )	nan <A> = <A> . replace ( <B> , np . nan )
ある行を <B> データフレームの中の未入力の値が取り除いた結果を <A> とする	<A> = <B> . dropna ( )	dropna <A> = <B> . dropna ( )
<A> データフレームを <B> ファイルという名前にして出力する	<A> . to_csv ( <B> )	to_csv <A> . to_csv ( <B> )
データフレーム <B> 全体をインデックスを軸に小さい順でソートされた結果を <A> にする	<A> = <B> . sort_index ( )	markerfacecolor = <B> . sort_index ( )
<A> データフレームの <B> 列と <C> コラムを降順にソートして、置き換える	<A> = <A> . sort_values ( [ <B> , <C> ] , ascending = False )	flush = <A> . sort_values ( [ <B> , <C> ] , ascending = False , inplace = True )
データフレーム <B> の中にある <C> を未入力の値に置き換えた結果を <A> に代入する	<A> = <B> . replace ( <C> , np . nan )	<B> <A> = <B> . replace ( <C> , np . nan )
ある行を <A> の中の未入力の値が取り除き、 <A> に代入する	<A> = <A> . dropna ( )	xticks <A> = <A> . dropna ( )
グラフの x 軸の軸ラベルを <A> にする	plt . xlabel ( <A> )	pd . xlabel ( <A> )
<A> の列にある <B> を数える	<A> . isin ( [ <B> ] ) . sum ( )	isin <A> . isin ( [ <B> ] ) . sum ( )
<A> データフレーム全体を <B> カラムと <C> 列を軸に逆順でソートし、置き換える	<A> = <A> . sort_values ( [ <B> , <C> ] , ascending = False )	flush = <A> . sort_values ( [ <B> , <C> ] , ascending = False , inplace = True )
<A> 内のカラムに存在する <B> の個数の和をチェックする	<A> . isin ( [ <B> ] ) . sum ( )	isin <A> [ <B> ] . sum ( )
データフレーム <A> のインデックスを振り直し、再代入する	<A> = <A> . reset_index ( )	errors = <A> . reset_index ( )
<B> データフレームの欠損値がある行をドロップして、 <A> とする	<A> = <B> . dropna ( )	errors = <B> . dropna ( )
<A> データフレームの先頭 5 行を見る	<A> . head ( )	<A> . tail ( )
<A> データフレームの <B> コラムと <C> を削除した結果で置き換える	<A> . drop ( [ <B> , <C> ] , axis = 1 , inplace = True )	marker = <A> . drop ( [ <B> , <C> ] , axis = 1 )
<A> をインデックスで小さい順に並び替えた結果を <A> にする	<A> = <A> . sort_index ( )	sort_index = <A> . sort_index ( )
<B> の <C> を未入力の値にした結果を <A> にする	<A> = <B> . replace ( <C> , np . nan )	<B> <A> = <B> . replace ( <C> , np . nan )
データフレーム <A> の <B> を欠損で補い、再代入する	<A> = <A> . replace ( <B> , np . nan )	nan <A> = <A> . replace ( <B> , np . nan )
<A> データフレーム全体をインデックスに沿って昇順でソートした結果を <A> にする	<A> = <A> . sort_index ( )	sort_index = <A> . sort_index ( )
星のマーカーを用いる	marker = '*'	markerfacecolor = '*'
エクセルファイル <B> のシート名 <C> をデータフレームにした結果を <A> にする	<A> = pd . read_excel ( <B> , sheet_name = <C> )	markerfacecolor = pd . read_excel ( <B> , sheet_name = <C> )
<B> と <C> を縦向きにマージし、 <A> にする	<A> = pd . concat ( [ <B> , <C> ] )	markerfacecolor = pd . concat ( [ <A> , <B> , <C> ] )
区関数は <A> を用いる	bins = <A>	range = ( <A> , <B> )
<C> から <D> にデータフレーム <B> の列名をリネームされた結果を <A> とする	<A> = <B> . rename ( columns = { <C> : <D> } )	} = <B> . rename ( columns = { <C> : <D> } )
箱ひげ図に <A> をする	plt . boxplot ( <A> )	<A> . sort_index ( )
ある行を <A> データフレームの中の未記入の値が取り除いた結果を <A> とする	<A> = <A> . dropna ( )	errors = <A> . dropna ( )
<A> データフレームの中の <B> コラムのダブる行を落として、 <A> に代入する	<A> = <A> . drop_duplicates ( subset = <B> )	mode = <A> . drop_duplicates ( subset = <B> )
<B> 内のカテゴリーを one - hot 表現にして、 <A> に代入する	<A> = pd . get_dummies ( <B> )	markerfacecolor = pd . get_dummies ( <A> , <B> )
バッファリングのサイズは <A> にする	buffering = <A>	fontsize = <A>
カラム <B> と列 <C> でデータフレーム <A> を逆順にソートする	<A> . sort_values ( [ <B> , <C> ] , ascending = False )	ascending . sort_values ( [ <A> [ <B> , <C> ] , ascending = False )
目印は六角形を適用する	marker = 'h'	markerfacecolor = 'h'
CSV データ <B> を表データとして読んだ結果を <A> とする	<A> = pd . read_csv ( <B> )	markerfacecolor = pd . read_csv ( <A> , <B> )
x 座標の軸ラベルを <A> に設定する	plt . xlabel ( <A> )	pd . xlabel ( <A> )
データフレーム <A> 内のカラムそれぞれに存在する <B> の個数の和	<A> . isin ( [ <B> ] ) . sum ( )	isin <A> [ <B> ] . sum ( )
データフレーム <A> のカラム名を <B> から <C> にした結果で置き換える	<A> = <A> . rename ( columns = { <B> : <C> } )	<B> <A> . rename ( columns = { <B> : <C> } , inplace = True )
重複があるのかどうかを <A> データフレームに真偽値で返す	<A> . duplicated ( )	duplicated <A> . duplicated ( )
<A> 内のそれぞれのカラムに存在する <B> の合計値	<A> . isin ( [ <B> ] ) . sum ( )	isin <A> = <B> . isin ( [ <C> ] ) . sum ( )
存在する <C> をデータフレーム <B> 中に欠損で埋めた結果を <A> に代入する	<A> = <B> . replace ( <C> , np . nan )	replace <A> = <B> . replace ( <C> , np . nan )
<A> の列名を <B> から <C> にし、インプレースする	<A> . rename ( columns = { <B> : <C> } , inplace = True )	<B> <A> . rename ( columns = { <C> : <D> } , inplace = True )
エクセルファイル <B> の <C> を読み込み、表に格納し、 <A> にする	<A> = pd . read_excel ( <B> , sheet_name = <C> )	markerfacecolor = pd . read_excel ( <B> , sheet_name = <C> )
データフレーム <B> のカラム <C> の秒を <A> とする	<A> = <B> [ <C> ] . dt . second	<A> = <B> [ <C> ] . dt [ dt [ dt . second
重複している最後の行を残して <A> 内の重複している行を削除された結果で置き換える	<A> . drop_duplicates ( keep = False , inplace = True )	<A> = <A> . drop_duplicates ( keep = False )
<B> の <C> を NaN に置換して、 <A> に代入する	<A> = <B> . replace ( <C> , np . nan )	<B> <A> = <B> . replace ( <C> , np . nan )
エクセルファイル <B> の <C> シート名を読み込み、 <A> に代入する	<A> = pd . read_excel ( <B> , sheet_name = <C> )	markerfacecolor = pd . read_excel ( <B> , sheet_name = <C> )
<B> の中のカテゴリーを数値データに変換して、 <A> にする	<A> = pd . get_dummies ( <B> )	markerfacecolor = pd . get_dummies ( <A> , <B> )
<A> と <B> の折れ線グラフをプロットする	plt . plot ( <A> , <B> )	plt . plot ( <A> [ <B> ] )
<B> の <C> を欠損値にして、 <A> とする	<A> = <B> . replace ( <C> , np . nan )	<B> <A> = <B> . replace ( <C> , np . nan )
<A> 中の未記入の値がある行を落とした結果で置き換える	<A> . dropna ( inplace = True )	dropna = <A> . dropna ( )
エクセルファイル <B> から読み込んだ結果を <A> にする	<A> = pd . read_excel ( <B> )	markerfacecolor = pd . read_excel ( <A> , <B> )
<A> データフレームの <B> を NaN にした結果を <A> にする	<A> = <A> . replace ( <B> , np . nan )	nan <A> = <A> . replace ( <B> , np . nan )
<B> 中のカテゴリ変数をダミー変数に変換した結果を <A> にする	<A> = pd . get_dummies ( <B> )	markerfacecolor = pd . get_dummies ( <A> , <B> )
マーカーの種類の色を赤とする	markerfacecolor = 'red'	markeredgecolor = 'red'
区関数を <D> として要素数が等しくなるように <B> の <C> を分割して、 <A> にする	<A> = pd . qcut ( <B> [ <C> ] , <D> )	marker = pd . qcut ( <B> [ <C> ] , <D> )
<B> データフレームと <C> データフレームをくっつけ、 <A> にする	<A> = pd . merge ( <B> , <C> )	plt . plot ( <A> , <B> , label = <C> )
<B> から <C> に <A> データフレームの列の名前をリネームし、置き換える	<A> = <A> . rename ( columns = { <B> : <C> } )	<A> . rename ( columns = { <B> : <C> } , inplace = True )
<A> 中に存在する <B> を NaN に置換して、書き換える	<A> . replace ( <B> , np . nan , inplace = True )	replace <A> . replace ( <B> , np . nan , inplace = True )
列番号 <B> をインデックスとして <A> を表に格納する	pd . read_csv ( <A> , index_col = <B> )	index_col pd . read_csv ( <A> , index_col = <B> , index_col = <B> )
データフレーム <A> の列 <B> とコラム <C> を降順にソートされた結果を再代入する	<A> = <A> . sort_values ( [ <B> , <C> ] , ascending = False )	[ <A> = <A> . sort_values ( [ <B> , <C> ] , ascending = False )
<A> 中のそれぞれのコラムにある <B> の個数の数	<A> . isin ( [ <B> ] ) . sum ( )	isin <A> = <B> . isin ( [ <C> ] ) . sum ( )
データフレーム <B> の中にある <C> を未入力の値で埋めた結果を <A> とする	<A> = <B> . replace ( <C> , np . nan )	<B> <A> = <B> . replace ( <C> , np . nan )
<A> を y 座標、 <B> を x 座標と指定して、グラフを表示する	plt . plot ( <A> , <B> )	<A> = <A> . drop ( <B> ) . mean ( )
<A> 中のそれぞれのコラムにある <B> の個数の合計	<A> . isin ( [ <B> ] ) . sum ( )	isin <A> = <B> . isin ( [ <C> ] ) . sum ( )
昇順にデータフレーム <A> のコラム <B> をソートし、置き換える	<A> = <A> . sort_values ( <B> )	<A> . sort_values ( <B> , inplace = True )
データフレーム <A> 全体をインデックスを元に小さい順でソートした結果を <A> とする	<A> = <A> . sort_index ( )	sort_index = <A> . sort_index ( )
エクセルファイル <A> を表データに読む	pd . read_excel ( <A> )	kind = pd . read_excel ( <A> )
エクセルファイル <A> の全てのシートをデータフレームにする	pd . read_excel ( <A> , sheet_name = None )	read_excel = pd . read_excel ( <A> , sheet_name = None )
データフレーム <A> 内に存在する <B> を欠損値にされた結果で置き換える	<A> . replace ( <B> , np . nan , inplace = True )	np . replace ( <A> , <B> , np . nan , inplace = True )
<B> データフレームの <C> コラムの名前を <D> に <F> に <E> 列の名前をリネームされた結果を <A> とする	<A> = <B> . rename ( columns = { <C> : <D> , <E> : <F> } )	<A> = <B> . drop_duplicates ( columns = { <C> : <D> , <E> : <F> } )
インデックスを元に <A> 全体を小さい順にソートし、置き換える	<A> . sort_index ( inplace = True )	kind = <A> . sort_index ( )
<A> データフレームの中の <B> コラムのダブっている行を取り除いて、再代入する	<A> = <A> . drop_duplicates ( subset = <B> )	markerfacecolor = <A> . drop_duplicates ( subset = <B> )
<A> 内の欠損値を含む行をドロップして、置き換える	<A> . dropna ( inplace = True )	dropna = <A> . dropna ( )
<A> データフレームにおいて <B> カラムと <C> カラムと <D> カラムの関係性を一気に表示する	sns . pairplot ( <A> [ [ <B> , <C> , <D> ] ] )	<A> . groupby ( [ <B> , <C> ] ) [ <D> ] . sum ( )
<A> 内の重複した行	<A> . duplicated ( ) . sum ( )	pd . duplicated ( ) . sum ( )
エクセルファイル <A> の <B> シート名を表に読む	pd . read_excel ( <A> , sheet_name = <B> )	<A> . pd . read_excel ( <B> , sheet_name = <B> )
<B> データフレームのインデックスを振り直して、 <A> とする	<A> = <B> . reset_index ( )	mode <A> = <B> . reset_index ( )
色をシアンとする	color = 'cyan'	markeredgecolor = 'cyan'
ある <B> を <A> データフレームの中に未入力の値に置き換え、置き換える	<A> = <A> . replace ( <B> , np . nan )	np . replace ( <A> , <B> , np . nan , inplace = True )
<A> を <B> というエクセルファイルとして保存する	<A> . to_excel ( <B> )	to_excel = <A> . to_excel ( <B> )
データフレーム <B> 中の NaN を <C> で埋められた結果を <A> に代入する	<A> = <B> . fillna ( <C> )	markeredgecolor = <B> . fillna ( <C> )
ある行をデータフレーム <A> 内の未記入の値がドロップする	<A> . dropna ( )	errors . dropna ( )
<B> データフレームの中の未記入の値を <C> で置き換え、 <A> とする	<A> = <B> . fillna ( <C> )	markeredgecolor = <B> . fillna ( <C> )
ビン数を <C> 、ビンのラベルを整数値として <A> データフレームの <B> コラムを分割する	pd . cut ( <A> [ <B> ] , <C> , label = False )	False = pd . cut ( <A> [ <B> ] , <C> , label = False )
コラム <C> にデータフレーム <B> を基づいて昇順でソートし、 <A> にする	<A> = <B> . sort_values ( <C> )	markerfacecolor = <B> . sort_values ( <C> )
<A> データフレームの <B> 列と <C> コラムと <D> カラムと <E> 列を抽出する	<A> [ [ <B> , <C> , <D> , <E> ] ]	sns . pairplot ( <A> [ [ <B> , <C> , <D> ] ] )
プロットしたプロットを <A> で保存する	plt . savefig ( <A> )	<A> = pd . savefig ( <B> )
<A> の中の欠損が存在する行を取り除いた結果を再代入する	<A> = <A> . dropna ( )	errors = <A> . dropna ( )
<A> の <B> を NaN で置換した結果で置き換える	<A> = <A> . replace ( <B> , np . nan )	np . replace ( <A> , <B> , np . nan , inplace = True )
<B> データフレーム中の NaN を消した結果を <A> とする	<A> = <B> . dropna ( )	dropna <A> = <B> . dropna ( )
出力先として <A> を適用する	file = <A>	plt . file ( <A> , <B> , file = <C> )
データフレーム <A> のカラム名を <B> から <C> にリネームして、書き換える	<A> . rename ( columns = { <B> : <C> } , inplace = True )	<B> <A> . rename ( columns = { <C> : <D> } , inplace = True )
シフト JIS に文字コードを指定する	encoding = 'shift_jis'	dt . 'shift_jis' ( 'shift_jis' , encoding = 'shift_jis' )
<B> の <C> を分割数を <D> として分割して、 <A> とする	<A> = pd . cut ( <B> [ <C> ] , <D> )	[ <A> = pd . cut ( <B> [ <C> ] , <D> )
データフレーム <A> の未記入の値がある行を落とす	<A> . dropna ( )	plt . dropna ( )
表として <A> をタブ区切りで読み込む	pd . read_csv ( <A> , sep = '\t' )	sep = pd . read_csv ( <A> , sep = '\t' )
存在する <B> を <A> データフレーム内に欠損値で置換し、置き換える	<A> . replace ( <B> , np . nan , inplace = True )	np . replace ( <A> , <B> , np . nan , inplace = True )
<A> の <B> についての標準偏差を得る	<A> [ <B> ] . std ( )	<A> [ [ <B> ] . std ( )
<B> の中の未入力の値を <C> に置き換えた結果を <A> とする	<A> = <B> . fillna ( <C> )	markeredgecolor = <B> . fillna ( <C> )
水平棒グラフを用いる	kind = 'barh'	flush = 'center'
要素の数が等しくなるようにビンの数を <D> として <B> データフレームの <C> コラムを分割し、 <A> とする	<A> = pd . qcut ( <B> [ <C> ] , <D> )	marker = pd . qcut ( <B> [ <C> ] , <D> )
<A> データフレームを <B> コラムに基づいて昇順でソートした結果で置き換える	<A> = <A> . sort_values ( <B> )	<A> . sort_values ( <B> , inplace = True )
データフレーム <A> の <B> を NaN で埋めた結果を <A> とする	<A> = <A> . replace ( <B> , np . nan )	nan <A> = <A> . replace ( <B> , np . nan )
<B> データフレーム内の <C> コラムの重複している行を削除し、 <A> とする	<A> = <B> . drop_duplicates ( subset = <C> )	markeredgecolor = <B> . drop_duplicates ( subset = <C> )
表示するカラム数を最大 <A> に変更する	pd . set_option ( 'display.max_columns' , <A> )	pd . set_option ( <A> , <B> , 'display.max_columns' = <A> )
<B> の水平棒グラフを軸を <A> として表示する	plt . barh ( <A> , <B> , align = 'center' )	<A> = plt . barh ( <B> , align = 'center' )
データフレーム <A> の中の未入力の値を <B> で置き換え、置き換える	<A> . fillna ( <B> , inplace = True )	<B> <A> . fillna ( <B> , inplace = True )
エクセルファイル <B> の <C> シート名をデータフレームとした結果を <A> とする	<A> = pd . read_excel ( <B> , sheet_name = <C> )	markerfacecolor = pd . read_excel ( <B> , sheet_name = <C> )
データフレーム <A> においてカラム <B> とカラム <C> とカラム <D> の関係性を一度に表示する	sns . pairplot ( <A> [ [ <B> , <C> , <D> ] ] )	pairplot sns . pairplot ( <A> [ [ <B> , <C> , <D> ] ] )
データフレーム <A> のカラム <B> とカラム <C> とカラム <D> の箱ひげ図を一枚のグラフで描写する	plt . boxplot ( [ <A> [ <B> ] , <A> [ <C> ] , <A> [ <D> ] ] )	pd . qcut ( <A> [ <B> ] , <C> , label = <D> )
<A> を <B> と <C> を元に逆順でソートし、置き換える	<A> = <A> . sort_values ( [ <B> , <C> ] , ascending = False )	flush = <A> . sort_values ( [ <B> , <C> ] , ascending = False , inplace = True )
<A> データフレーム中の未記入の値を <B> で置き換え、置き換える	<A> = <A> . fillna ( <B> )	<B> <A> . fillna ( <B> , inplace = True )
グラフにグリッドをつける	plt . grid ( True )	grid = plt . grid ( True )
データフレーム <A> のコラム <B> と <C> を取り除いた結果で置き換える	<A> = <A> . drop ( [ <B> , <C> ] , axis = 1 )	[ <A> . drop ( [ <B> , <C> ] , axis = 1 , inplace = True )
<A> データフレーム内に欠損があるか数える	<A> . isnull ( ) . sum ( )	isnull <A> . isnull ( ) . sum ( )
データフレーム <B> 全体をインデックスを元に昇順でソートし、 <A> にする	<A> = <B> . sort_index ( )	markerfacecolor = <B> . sort_index ( )
<B> ファイルという名前で CSV ファイルとして <A> データフレームを保存する	<A> . to_csv ( <B> )	to_csv <A> . to_csv ( <B> )
<A> データフレーム中に存在する <B> を欠損で置換した結果を <A> にする	<A> = <A> . replace ( <B> , np . nan )	nan <A> = <A> . replace ( <B> , np . nan )
<B> というファイル名でエクセル形式に <A> データフレームを書き込む	<A> . to_excel ( <B> )	markerfacecolor = <A> . to_excel ( <B> )
データフレーム <A> の先頭から <B> 行目まで	<A> [ : <B> ]	range = ( <A> [ <B> ] )
列名を指定せずに <A> データを読み込む	pd . read_csv ( <A> , header = None )	None = pd . read_csv ( <A> , header = None )
データフレーム <B> 中の <C> を NaN に変え NaN が存在する行を消した結果を <A> に代入する	<A> = <B> . replace ( <C> , np . nan ) . dropna ( )	markeredgecolor = <B> . replace ( <C> , np . nan ) . dropna ( )
<B> データフレームの中の未記入の値を <C> とした結果を <A> にする	<A> = <B> . fillna ( <C> )	markeredgecolor = <B> . fillna ( <C> )
データフレーム <A> のもともとあったインデックスをリセットした結果で置き換える	<A> . reset_index ( drop = True , inplace = True )	<A> = <A> . reset_index ( drop = True )
<A> データフレーム全体を <B> カラムと <C> 列に基づいて降順でソートして、 <A> にする	<A> = <A> . sort_values ( [ <B> , <C> ] , ascending = False )	[ <A> = <A> . sort_values ( [ <B> , <C> ] , ascending = False )
エクセルファイル <B> の <C> シート名から読み込んだ結果を <A> にする	<A> = pd . read_excel ( <B> , sheet_name = <C> )	markerfacecolor = pd . read_excel ( <B> , sheet_name = <C> )
データフレーム <A> 内の欠損値をデータフレーム <A> の平均値で埋められた結果を <A> に代入する	<A> = <A> . fillna ( <A> . mean ( ) )	mean <A> . fillna ( <A> . mean ( ) , inplace = True )
左側のデータのインデックスと <C> をキーとして <A> と <B> をマージする	pd . merge ( <A> , <B> , left_index = True , right_on = <C> )	<A> . pd . merge ( <B> , <C> , left_index = True , right_on = <D> )
区間を <C> 、ビンのラベルを <D> として <A> の <B> を分割する	pd . cut ( <A> [ <B> ] , <C> , label = <D> )	<A> = pd . cut ( <B> [ <C> ] , <D> , label = <E> )
コラム <D> をキーとしてデータフレーム <B> とデータフレーム <C> をマージした結果を <A> に代入する	<A> = pd . merge ( <B> , <C> , on = <D> )	merge <A> = pd . merge ( <B> , <C> , on = <D> )
目印をバツ印とする	marker = 'x'	linestyle = 'x'
<A> にある未記入の値の数を調べる	<A> . isnull ( ) . sum ( )	plt . isnull ( ) . sum ( )
<A> データフレーム中の NaN がある行を落とされた結果を <A> にする	<A> = <A> . dropna ( )	errors = <A> . dropna ( )
エクセルファイル <A> のシート名 <B> を読み込み、表とする	pd . read_excel ( <A> , sheet_name = <B> )	<A> . pd . read_excel ( <B> , sheet_name = <B> )
<A> データフレームと <B> データフレームを <C> コラムをキーとしてマージする	pd . merge ( <A> , <B> , on = <C> )	<A> . pd . merge ( <B> , <C> , on = <D> )
データフレーム <A> の列名を <D> から <E> に <B> から <C> にリネームした結果を <A> に代入する	<A> = <A> . rename ( columns = { <B> : <C> , <D> : <E> } )	<B> <A> . rename ( columns = { <B> : <C> , <D> : <E> } , inplace = True )
<A> データフレームの中の <B> コラムに重複がある行を落とし、再代入する	<A> = <A> . drop_duplicates ( subset = <B> )	markerfacecolor = <A> . drop_duplicates ( subset = <B> )
<B> の中のカテゴリーを one - hot 表現にした結果を <A> にする	<A> = pd . get_dummies ( <B> )	markerfacecolor = pd . get_dummies ( <A> , <B> )
<A> データフレーム全体をインデックスを元に小さい順でソートされた結果を <A> に代入する	<A> = <A> . sort_index ( )	sort_index = <A> . sort_index ( )
UTF8 を適用する	encoding = 'utf-8'	start = 'utf-8'
データフレーム <A> 中の未記入の値をデータフレーム <A> の平均をとって補った結果で置き換える	<A> = <A> . fillna ( <A> . mean ( ) )	pd . fillna ( <A> . mean ( ) , inplace = True )
データフレーム <A> のコラム <B> の名前を <C> に <E> に列 <D> の名前をリネームされた結果で置き換える	<A> . rename ( columns = { <B> : <C> , <D> : <E> } , inplace = True )	<B> <A> . rename ( columns = { <B> : <C> , <D> : <E> } , inplace = True )
データフレーム <A> のコラム <B> をビン数を <C> 、ビンの名前をリスト <D> として分割する	pd . cut ( <A> [ <B> ] , <C> , label = <D> )	<A> = pd . cut ( <B> [ <C> ] , <D> , label = <E> )
<A> 中の欠損を <B> に置き換えられた結果で置き換える	<A> . fillna ( <B> , inplace = True )	flush = <A> . fillna ( <B> )
<A> データフレームの中の未入力の値を <A> データフレームの平均で補った結果で書き換える	<A> . fillna ( <A> . mean ( ) , inplace = True )	pd . fillna ( <A> . mean ( ) , inplace = True )
昇順に <B> で <A> をソートして、 <A> に代入する	<A> = <A> . sort_values ( <B> )	plt . sort_values <A> <B> , inplace = True )
<A> データフレームのインデックス名を <B> から <C> にリネームする	<A> . rename ( index = { <B> : <C> } )	<B> <A> . rename ( index = { <C> : <D> } )
<A> データフレーム中の未記入の値を <A> データフレームの平均で補われた、結果で書き換える	<A> . fillna ( <A> . mean ( ) , inplace = True )	pd . fillna ( <A> . mean ( ) , inplace = True )
データフレーム <A> を <B> というファイル名でエクセル形式に書き出す	<A> . to_excel ( <B> )	to_excel . to_excel ( <A> [ <B> ] )
文字コードがシフト JIS の <A> を読む	pd . read_csv ( <A> , encoding = 'shift_jis' )	<A> . pd . read_csv ( <B> , encoding = 'shift_jis' )
データフレーム <A> の中の未入力の値を直前の行の値で埋める	<A> . fillna ( method = 'ffill' )	<B> <A> . fillna ( method = 'ffill' )
<A> 内のカテゴリーを数値に変える	pd . get_dummies ( <A> )	get_dummies = pd . get_dummies ( <A> )
マーカーの形状はアスタリスクを用いる	marker = '*'	markerfacecolor = '*'
棒と棒の隙間を <C> としてグラフの <A> 軸を <A> とした <B> の棒グラフを描写する	plt . bar ( <A> , <B> , width = <C> )	bar plt . bar ( <A> , <B> , width = <C> )
データフレーム <A> 中の NaN がある行を消して、 <A> に代入する	<A> = <A> . dropna ( )	errors = <A> . dropna ( )
エクセルファイル <A> のシート名 <B> を表に格納する	pd . read_excel ( <A> , sheet_name = <B> )	sheet_name = pd . read_excel ( <A> , sheet_name = <B> )
データフレーム <B> 内の欠損値を含む行をドロップして、 <A> に代入する	<A> = <B> . dropna ( )	dropna <A> = <B> . dropna ( )
データフレーム <A> の <B> を未入力の値で置き換えられた結果を再代入する	<A> = <A> . replace ( <B> , np . nan )	nan <A> = <A> . replace ( <B> , np . nan )
マーカーの形状の色は紺色を使用する	markerfacecolor = 'navy'	markeredgecolor = 'navy'
先頭の列をインデックスと設定して、 <B> データを表として読んで、 <A> にする	<A> = pd . read_csv ( <B> , index_col = 0 )	0 = pd . read_csv ( <A> , index_col = 0 )
<B> と <C> で <A> 全体を降順にソートした結果を <A> とする	<A> = <A> . sort_values ( [ <B> , <C> ] , ascending = False )	[ <A> = <A> . sort_values ( [ <B> , <C> ] , ascending = False )
<B> データフレーム中にある <C> を未記入の値に置き換えた結果を <A> に代入する	<A> = <B> . replace ( <C> , np . nan )	<B> <A> = <B> . replace ( <C> , np . nan )
<A> という名前のエクセルファイルのシート名 <B> を表データとして読み込む	pd . read_excel ( <A> , sheet_name = <B> )	<A> . pd . read_excel ( <B> , sheet_name = <B> )
<A> のカラム名を <B> から <C> に変更する	<A> . rename ( columns = { <B> : <C> } )	plt . hist ( <A> [ <B> ] )
表として <A> をタブ区切りで読む	pd . read_csv ( <A> , sep = '\t' )	sep = pd . read_csv ( <A> , sep = '\t' )
存在する <C> を <B> 内に欠損値で置換した結果を <A> とする	<A> = <B> . replace ( <C> , np . nan )	<B> <A> = <B> . replace ( <C> , np . nan )
エクセルファイル <A> の <B> 番目のシートを読み込み、表データに格納する	pd . read_excel ( <A> , sheet_name = <B> )	<A> = pd . read_excel ( <B> , sheet_name = <C> )
ピボット操作で <A> の行を列に入れ替える	<A> . unstack ( )	<A> . stack ( )
データ <B> から表データをタブ区切りで読み、 <A> に代入する	<A> = pd . read_csv ( <B> , sep = '\t' )	plt . read_csv ( <A> , sep = '\t' )
エクセルファイル <B> の <C> シート名を読み込んで表データにして、 <A> にする	<A> = pd . read_excel ( <B> , sheet_name = <C> )	markerfacecolor = pd . read_excel ( <B> , sheet_name = <C> )
<A> の中の <B> に重複がある行を落とされた結果を <A> に代入する	<A> = <A> . drop_duplicates ( subset = <B> )	markerfacecolor = <A> . drop_duplicates ( subset = <B> )
<A> データフレーム内の <B> コラムと <C> カラムに重複はあるのかどうか	<A> . duplicated ( subset = [ <B> , <C> ] )	<B> <A> . duplicated ( subset = [ <C> , <D> ] )
<B> データからデータフレームで読み込んだ結果を <A> に代入する	<A> = pd . read_csv ( <B> )	markerfacecolor = pd . read_csv ( <A> , <B> )
<B> の <C> をインデックス、 <D> を列としたピボットテーブルを作成し、 <A> に代入する	<A> = <B> . pivot_table ( index = <C> , columns = <D> )	markerfacecolor = <B> . pivot_table ( index = <C> , columns = <D> )
データフレーム <A> の中のそれぞれの列に存在する <B> の数の数	<A> . isin ( [ <B> ] ) . sum ( )	isin <A> [ <B> ] . sum ( )
棒グラフの位置を中心に設定して、 <A> 軸を <A> とした <B> の縦向き棒グラフを表示する	plt . bar ( <A> , <B> , align = 'center' )	<A> = pd . bar ( <B> , align = 'center' )
<A> データフレーム内に存在する <B> を欠損値とした結果で置き換える	<A> = <A> . replace ( <B> , np . nan )	np . replace ( <A> , <B> , np . nan , inplace = True )
<A> を <B> に書き出す	<A> . to_csv ( <B> )	to_csv <A> . to_csv ( <B> )
<A> の <B> をインデックスとしてセットする	<A> . set_index ( <B> )	plt . set_index ( <A> , <B> )
データフレームに <B> を格納された結果を <A> にする	<A> = pd . read_csv ( <B> )	<A> = pd . merge ( <B> , axis = 1 )
表データとして <A> をカンマ区切りで読み込む	pd . read_csv ( <A> , sep = ',' )	<A> . pd . read_csv ( <B> , sep = ',' )
データフレーム <A> 中の NaN をデータフレーム <A> の平均で補い、インプレースする	<A> . fillna ( <A> . mean ( ) , inplace = True )	pd . fillna ( <A> . mean ( ) , inplace = True )
データフレーム <B> の中にある <C> を未入力の値で補い、 <A> に代入する	<A> = <B> . replace ( <C> , np . nan )	<B> <A> = <B> . replace ( <C> , np . nan )
データフレーム <B> のコラム <C> を境界値をリスト <D> として分割して、 <A> とする	<A> = pd . cut ( <B> [ <C> ] , <D> )	[ <A> = pd . cut ( <B> [ <C> ] , <D> )
<A> を <B> と <C> が逆順になるようにソートされた結果で置き換える	<A> = <A> . sort_values ( [ <B> , <C> ] , ascending = False )	flush = <A> . sort_values ( [ <B> , <C> ] , ascending = False , inplace = True )
<A> という名前のエクセルファイルをデータフレームとして読む	pd . read_excel ( <A> )	kind = pd . read_excel ( <A> )
<A> データフレームの <B> コラムと <C> を取り除かれた結果で置き換える	<A> = <A> . drop ( [ <B> , <C> ] , axis = 1 )	flush = <A> . drop ( [ <B> , <C> ] , axis = 1 , inplace = True )
<A> データフレームのインデックスをリセットでインプレースする	<A> . reset_index ( inplace = True )	inplace = <A> . reset_index ( )
<A> の <B> を欠損値で埋め、 <A> に代入する	<A> = <A> . replace ( <B> , np . nan )	nan <A> = <A> . replace ( <B> , np . nan )
<A> データフレームの未入力の値を <B> に変え、置き換える	<A> = <A> . fillna ( <B> )	<B> <A> . fillna ( <B> , inplace = True )
データフレーム <B> のコラム <E> についてカラム <C> をインデックス、カラム <D> を列としたピボットテーブルを作成した結果を <A> にする	<A> = <B> . pivot_table ( index = <C> , columns = <D> , values = <E> )	plt . bar ( <A> , <B> , values = <C> , values = <D> )
<B> データフレームと <C> データフレームを 1 つにまとめ、 <A> とする	<A> = pd . merge ( <B> , <C> )	plot <A> = <A> . drop ( [ <B> , <C> ] , axis = 1 )
<A> データフレームの中の未入力の値を <A> データフレームの平均をとって補って、置き換える	<A> . fillna ( <A> . mean ( ) , inplace = True )	pd . fillna ( <A> . mean ( ) , inplace = True )
<A> を <B> という CSV データとしてセーブする	<A> . to_csv ( <B> )	plt . to_csv ( <A> , <B> , to_csv = '
データフレーム <A> をエクセルファイル <B> に表示する	<A> . to_excel ( <B> )	to_excel <A> . to_excel ( <B> )
列の最大表示幅を <A> にする	pd . set_option ( 'max_colwidth' , <A> )	'display.max_columns' = pd . set_option ( 'display.max_columns' , <A> )
( <A> [ <B> ] ) の統計情報を抽出する	<A> [ <B> ] . describe ( )	mode = <A> [ <B> ] . describe ( )
<A> 上のインデックスが <B> の行	<A> . loc [ <B> ]	<A> . set_index ( <B> )
<A> データフレームの <B> を NaN で補われた、結果を再代入する	<A> = <A> . replace ( <B> , np . nan )	nan <A> = <A> . replace ( <B> , np . nan )
<A> データフレームの中の未入力の値を直前の行の値で埋めた結果で置き換える	<A> = <A> . fillna ( method = 'ffill' )	<B> <A> . fillna ( method = 'ffill' , inplace = True )
<A> データフレームの <B> を未入力の値に置き換え、置き換える	<A> = <A> . replace ( <B> , np . nan )	np . replace ( <A> , <B> , np . nan , inplace = True )
ある <B> を <A> データフレーム中に NaN として、置き換える	<A> . replace ( <B> , np . nan , inplace = True )	np . replace ( <A> , <B> , np . nan , inplace = True )
データフレーム <A> のカラム <B> とカラム <C> とカラム <D> について関係性を一気に表示する	sns . pairplot ( <A> [ [ <B> , <C> , <D> ] ] )	pairplot sns . pairplot ( <A> [ [ <B> , <C> , <D> ] ] )
線グラフの種類は鉛直棒グラフを用いる	kind = 'bar'	plt . bar ( <A> , <B> , align = 'center' )
<B> の中の未記入の値を落とし、 <A> とする	<A> = <B> . dropna ( )	dropna <A> = <B> . dropna ( )
元のインデックスを削除してから、データフレーム <A> のインデックスをリセットする	<A> . reset_index ( drop = True )	<B> <A> . reset_index ( drop = True )
<A> データフレームの中にある <B> を未記入の値で置き換え、 <A> とする	<A> = <A> . replace ( <B> , np . nan )	nan <A> = <A> . replace ( <B> , np . nan )
タブ区切りでデータ <B> を読み、 <A> にする	<A> = pd . read_csv ( <B> , sep = '\t' )	plt . read_csv ( <A> , sep = '\t' )
ある行をデータフレーム <B> 中の欠損値が落として、 <A> とする	<A> = <B> . dropna ( )	dropna <A> = <B> . dropna ( )
<C> から <D> にデータフレーム <B> のカラム名を変更した結果を <A> に代入する	<A> = <B> . rename ( columns = { <C> : <D> } )	} = { <B> . rename ( columns = { <C> : <D> } )
データフレーム <A> の中にある <B> を未入力の値に置き換え、再代入する	<A> = <A> . replace ( <B> , np . nan )	nan <A> = <A> . replace ( <B> , np . nan )
<A> 内のカラムに存在する <B> の個数の合計値をチェックする	<A> . isin ( [ <B> ] ) . sum ( )	isin <A> [ <B> ] . sum ( )
データフレーム <A> 中の NaN をデータフレーム <A> の平均で補われた、結果でインプレースする	<A> . fillna ( <A> . mean ( ) , inplace = True )	pd . fillna ( <A> . mean ( ) , inplace = True )
<A> 内に重複があるかどうか確認する	<A> . duplicated ( )	duplicated <A> . duplicated ( )
目印を菱形とする	marker = 'D'	markerfacecolor = 'D'
データフレーム <B> 中にある <C> を未記入の値とした結果を <A> にする	<A> = <B> . replace ( <C> , np . nan )	<B> <A> = <B> . replace ( <C> , np . nan )
<A> データフレーム内のカテゴリ変数を one - hot 表現に変換する	pd . get_dummies ( <A> )	get_dummies = pd . get_dummies ( <A> )
数値で扱えるようにデータフレーム <B> の数値以外のデータを処理して、 <A> に代入する	<A> = pd . get_dummies ( <B> )	markerfacecolor = pd . get_dummies ( <A> , <B> )
色を青とする	color = 'blue'	markeredgecolor = 'blue'
データフレーム <A> の欠損値がある行をドロップする	<A> . dropna ( )	errors . dropna ( )
データフレーム <A> をインデックスを元に小さい順でソートし、 <A> とする	<A> = <A> . sort_index ( )	sort_index = <A> . sort_index ( )
<A> の中のそれぞれの列にある <B> の数を見る	<A> . isin ( [ <B> ] ) . sum ( )	isin <A> = <B> . isin ( [ <C> ] ) . sum ( )
<B> というファイル名でエクセルに <A> データフレームを書き出す	<A> . to_excel ( <B> )	markerfacecolor = <A> . to_excel ( <B> )
<A> データフレームをインデックスを元に小さい順でソートした結果を <A> にする	<A> = <A> . sort_index ( )	sort_index = <A> . sort_index ( )
列番号 <C> をインデックスとして <B> から表を読み込んで、 <A> に代入する	<A> = pd . read_csv ( <B> , index_col = <C> )	markeredgecolor = pd . read_csv ( <B> , index_col = <C> )
<C> から <D> に <B> の列の名前をし、 <A> にする	<A> = <B> . rename ( columns = { <C> : <D> } )	} = <B> . rename ( columns = { <C> : <D> } )
ある行をデータフレーム <A> 内の欠損が削除された結果を <A> とする	<A> = <A> . dropna ( )	errors = <A> . dropna ( )
列番号 <B> をインデックスとして <A> データを表データに格納する	pd . read_csv ( <A> , index_col = <B> )	set_index = pd . read_csv ( <A> , index_col = <B> )
データフレーム <B> の中の未入力の値を含む行を取り除いた結果を <A> に代入する	<A> = <B> . dropna ( )	dropna <A> = <B> . dropna ( )
<A> 中の未記入の値がある行を落とす	<A> . dropna ( )	plt . dropna ( )
存在する行を <A> 内の未記入の値がドロップし、 <A> にする	<A> = <A> . dropna ( )	autopct = <A> . dropna ( )
グラフの種類は縦向き棒グラフを用いる	kind = 'bar'	flush = 'bar'
<A> 内の欠損を <B> で埋める	<A> . fillna ( <B> )	plt . fillna ( <A> , <B> )
全結合で <A> と <B> をマージする	pd . merge ( <A> , <B> , how = 'outer' )	start = pd . merge ( <A> , <B> , how = 'outer' )
表として CSV データ <B> を <C> 区切りで読んで、 <A> に代入する	<A> = pd . read_csv ( <B> , sep = <C> )	pd . read_csv ( <A> , sep = <B> )
<A> の <B> についての標準偏差を表示する	<A> [ <B> ] . std ( )	<A> [ [ <B> ] . std ( )
データフレーム <A> の中の <B> を未入力の値に置換し未入力の値がある行を取り除かれた結果で置き換える	<A> = <A> . replace ( <B> , np . nan ) . dropna ( )	<A> . replace ( <B> , np . nan ) . dropna ( inplace = True )
棒グラフの位置を中心に設定して、グラフの <A> 軸を <A> とした <B> の垂直棒グラフを描写する	plt . bar ( <A> , <B> , align = 'center' )	<A> = pd . bar ( <B> , align = 'center' )
データフレーム <A> 中に存在する <B> を欠損で置換した結果で置き換える	<A> . replace ( <B> , np . nan , inplace = True )	np . replace ( <A> , <B> , np . nan , inplace = True )
ダブる最後の行を残してデータフレーム <A> の中の重複している行を落とす	<A> . drop_duplicates ( keep = False )	<B> <A> . drop_duplicates ( keep = False )
打点の色は黄色を使う	markerfacecolor = 'yellow'	markeredgecolor = 'yellow'
<A> データフレームをインデックスどおりに昇順でソートして、置き換える	<A> . sort_index ( inplace = True )	kind = <A> . sort_index ( )
データフレーム <A> 内のそれぞれのカラムに存在する <B> の合計をチェックする	<A> . isin ( [ <B> ] ) . sum ( )	isin <A> [ <B> ] . sum ( )
表データとしてデータ <A> をタブ区切りで読み込む	pd . read_csv ( <A> , sep = '\t' )	sep = pd . read_csv ( <A> , sep = '\t' )
<A> 行に最大表示行数を設定する	pd . set_option ( 'display.max_rows' , <A> )	start = pd . set_option ( 'display.max_rows' , <A> )
先頭の列をインデックスとセットして、 <B> を表データとして読み込み、 <A> にする	<A> = pd . read_csv ( <B> , index_col = 0 )	0 = pd . read_csv ( <A> , index_col = 0 )
<B> のカラム名を <C> から <D> にした結果を <A> に代入する	<A> = <B> . rename ( columns = { <C> : <D> } )	} = { <B> . rename ( columns = { <C> : <D> } )
データフレーム <A> を <B> というファイル名でエクセル形式で出力する	<A> . to_excel ( <B> )	range = ( <A> [ <B> ] )
<A> 中にある <B> を未記入の値にして、インプレースする	<A> . replace ( <B> , np . nan , inplace = True )	replace <A> . replace ( <B> , np . nan , inplace = True )
データフレーム <B> のコラム <C> を要素の数が等しくなるように区関数を <D> として分割し、 <A> に代入する	<A> = pd . qcut ( <B> [ <C> ] , <D> )	marker = pd . qcut ( <B> [ <C> ] , <D> )
<A> 全体をインデックスを軸に昇順でソートされた結果で置き換える	<A> . sort_index ( inplace = True )	kind = <A> . sort_index ( )
<B> データフレーム内に存在する <C> を欠損で置換した結果を <A> にする	<A> = <B> . replace ( <C> , np . nan )	<B> <A> = <B> . replace ( <C> , np . nan )
データフレーム <A> のコラム <B> と <C> を消した結果で書き換える	<A> . drop ( [ <B> , <C> ] , axis = 1 , inplace = True )	pd . merge ( <A> , <B> , axis = 1 , inplace = True )
<B> データフレームの <C> を NaN に置換して、 <A> に代入する	<A> = <B> . replace ( <C> , np . nan )	<B> <A> = <B> . replace ( <C> , np . nan )
データフレーム <B> 内の欠損値を <C> で埋め、 <A> とする	<A> = <B> . fillna ( <C> )	markeredgecolor = <B> . fillna ( <C> )
<A> データフレーム中に重複はあるのか確認	<A> . duplicated ( )	duplicated <A> . duplicated ( )
データフレーム <A> の <B> を未記入の値にされた結果を <A> とする	<A> = <A> . replace ( <B> , np . nan )	nan <A> = <A> . replace ( <B> , np . nan )
<A> データフレームのインデックスをリセット、元のインデックスを削除した結果を <A> に代入する	<A> = <A> . reset_index ( drop = True )	markeredgecolor = <A> . reset_index ( drop = True )
データフレーム <B> の列名を <E> から <F> に <C> から <D> にリネームし、 <A> にする	<A> = <B> . rename ( columns = { <C> : <D> , <E> : <F> } )	<A> = <B> . drop_duplicates ( columns = { <C> : <D> , <E> : <F> } )
<A> の <B> を区間を <C> として分割する	pd . cut ( <A> [ <B> ] , <C> )	<A> = pd . cut ( <B> [ <C> ] , <D> )
<A> 中のコラムに存在する <B> の個数を表示する	<A> . isin ( [ <B> ] ) . sum ( )	isin <A> [ <B> ] . sum ( )
<B> データフレームの中の未入力の値を <C> に置換した結果を <A> に代入する	<A> = <B> . fillna ( <C> )	markeredgecolor = <B> . fillna ( <C> )
データフレーム <A> の中にある <B> を未入力の値で置き換えた結果で書き換える	<A> . replace ( <B> , np . nan , inplace = True )	replace <A> . replace ( <B> , np . nan , inplace = True )
<A> データフレームと <B> データフレームを横に一つにまとめる	pd . merge ( <A> , <B> )	alpha = <A> . pd . merge ( <B> )
データフレーム <A> の中にある <B> を未記入の値に置き換え、再代入する	<A> = <A> . replace ( <B> , np . nan )	nan <A> = <A> . replace ( <B> , np . nan )
データフレーム <A> をカラム <B> と列 <C> に基づいて降順でソートする	<A> . sort_values ( [ <B> , <C> ] , ascending = False )	<B> <A> . sort_values ( [ <B> , <C> ] , ascending = False )
データフレーム <B> のカラム名を <E> から <F> に <C> から <D> にリネームした結果を <A> とする	<A> = <B> . rename ( columns = { <C> : <D> , <E> : <F> } )	<A> = <B> . drop_duplicates ( columns = { <C> : <D> , <E> : <F> } )
<B> データから表をタブ区切りで読んだ結果を <A> とする	<A> = pd . read_csv ( <B> , sep = '\t' )	plt . read_csv ( <A> , sep = '\t' )
ビンの数を <C> 、ビンの名前をリスト <D> としてデータフレーム <A> のコラム <B> を分割する	pd . cut ( <A> [ <B> ] , <C> , label = <D> )	<A> = pd . cut ( <B> [ <C> ] , <D> , label = <E> )
ある行をデータフレーム <A> 内の未入力の値が削除した結果を <A> とする	<A> = <A> . dropna ( )	autopct = <A> . dropna ( )
<C> をキーとして <A> と <B> をマージする	pd . merge ( <A> , <B> , on = <C> )	marker = pd . merge ( <A> , <B> , on = <C> )
<A> 全体を <B> と <C> を軸に逆順でソートされた結果を <A> に代入する	<A> = <A> . sort_values ( [ <B> , <C> ] , ascending = False )	[ <A> = <A> . sort_values ( [ <B> , <C> ] , ascending = False )
エクセルファイル <B> の <C> 番目のシートからデータフレームを読み込んだ結果を <A> にする	<A> = pd . read_excel ( <B> , sheet_name = <C> )	markerfacecolor = pd . read_excel ( <B> , sheet_name = <C> )
<A> データフレームの未入力の値を <B> にされた結果を <A> にする	<A> = <A> . fillna ( <B> )	plt . fillna ( <A> , <B> , inplace = True )
<B> データから表で読み込んで、 <A> にする	<A> = pd . read_csv ( <B> )	markerfacecolor = pd . read_csv ( <B> )
<A> の <B> を未入力の値に置き換え、置き換える	<A> . replace ( <B> , np . nan , inplace = True )	np . replace ( <A> , <B> , np . nan , inplace = True )
<B> と <C> を横に一つにし、 <A> に代入する	<A> = pd . merge ( <B> , <C> )	pd . merge ( <A> , <B> , on = <C> )
<A> データフレーム全体を <B> カラムと <C> 列を軸に降順でソートした結果を <A> にする	<A> = <A> . sort_values ( [ <B> , <C> ] , ascending = False )	[ <A> = <A> . sort_values ( [ <B> , <C> ] , ascending = False )
ビンの数は <A> を用いる	bins = <A>	range = ( <A> , <B> )
エクセルファイル <B> の <C> を読み込んで表データに格納して、 <A> とする	<A> = pd . read_excel ( <B> , sheet_name = <C> )	markeredgecolor = pd . read_excel ( <B> , sheet_name = <C> )
タブ区切りでデータ <B> を読み込んで、 <A> に代入する	<A> = pd . read_csv ( <B> , sep = '\t' )	plt . read_csv ( <A> , sep = '\t' )
<B> データを表に格納された結果を <A> にする	<A> = pd . read_csv ( <B> )	markerfacecolor = pd . read_csv ( <B> )
エクセルファイル <B> から表データを読み込んだ結果を <A> に代入する	<A> = pd . read_excel ( <B> )	markerfacecolor = pd . read_excel ( <A> , <B> )
<A> データフレーム中の欠損を <B> に置き換えた結果で置き換える	<A> = <A> . fillna ( <B> )	<B> <A> . fillna ( <B> , inplace = True )
密度推定を用いる	kind = 'density'	byteorder = 'density'
線グラフを赤紫色で表示する	color = 'magenta'	markerfacecolor = 'magenta'
<A> データフレームの中の <B> を未記入の値に変え未記入の値がある行を落とす	<A> . replace ( <B> , np . nan ) . dropna ( )	replace <A> . replace ( <B> , np . nan ) . dropna ( )
マーカーの形状の色は赤色を用いる	markerfacecolor = 'red'	markeredgecolor = 'red'
カラム <B> と列 <C> でデータフレーム <A> を逆順にソートした結果で置き換える	<A> . sort_values ( [ <B> , <C> ] , ascending = False , inplace = True )	flush = <A> . sort_values ( [ <B> , <C> ] , ascending = False , inplace = True )
<A> データフレームの中にある <B> を未入力の値にした結果を <A> とする	<A> = <A> . replace ( <B> , np . nan )	nan <A> = <A> . replace ( <B> , np . nan )
<C> から <D> に <B> データフレームのカラム名を変更して、 <A> にする	<A> = <B> . rename ( columns = { <C> : <D> } )	} = { <B> . rename ( columns = { <C> : <D> } )
<A> データフレームを <B> コラムを軸に昇順でソートして、再代入する	<A> = <A> . sort_values ( <B> )	plt . sort_values ( <A> , <B> , inplace = True )
データフレーム <A> 内に存在する <B> を欠損値で置換した結果で置き換える	<A> = <A> . replace ( <B> , np . nan )	np . replace ( <A> , <B> , np . nan , inplace = True )
<A> の未記入の値を <B> にし、置き換える	<A> = <A> . fillna ( <B> )	<B> <A> . fillna ( <B> , inplace = True )
エクセルファイル <A> のシート名 <B> を読み込んで表データにする	pd . read_excel ( <A> , sheet_name = <B> )	<A> . pd . read_excel ( <B> , sheet_name = <B> )
データフレーム <A> のコラム <B> を取り除かれた結果でインプレースする	<A> . drop ( <B> , axis = 1 , inplace = True )	pd . merge ( <A> , <B> , axis = 1 , inplace = True )
先頭の列をインデックスと設定して、データ <B> をデータフレームとして読み込み、 <A> とする	<A> = pd . read_csv ( <B> , index_col = 0 )	markerfacecolor = pd . read_csv ( <A> , index_col = 0 )
<A> 内の欠損の合計値	<A> . isnull ( ) . sum ( )	isnull <A> . isnull ( ) . sum ( )
<B> という名前のエクセルファイルの <C> シート名を表として読んだ結果を <A> に代入する	<A> = pd . read_excel ( <B> , sheet_name = <C> )	markerfacecolor = pd . read_excel ( <B> , sheet_name = <C> )
<A> のインデックスをリセット	<A> . reset_index ( )	reset_index <A> . reset_index ( )
データフレーム <A> 中の NaN をデータフレーム <A> の平均値で埋めた結果を再代入する	<A> = <A> . fillna ( <A> . mean ( ) )	mean <A> . fillna ( <A> . mean ( ) , inplace = True )
データフレーム <A> の <B> 行目を削除する	<A> . drop ( <B> )	plt . drop ( <A> , <B> , inplace = True )
エクセルファイル <B> の <C> シート名を読み込み、データフレームに格納し、 <A> にする	<A> = pd . read_excel ( <B> , sheet_name = <C> )	markerfacecolor = pd . read_excel ( <B> , sheet_name = <C> )
<A> の <B> の名前を <C> にリネームし、再代入する	<A> = <A> . rename ( columns = { <B> : <C> } )	{ <A> = <A> . rename ( columns = { <B> : <C> } )
データフレーム <B> 中の未記入の値を <C> として、 <A> にする	<A> = <B> . fillna ( <C> )	plt . fillna ( <A> , <B> , inplace = True )
<A> データフレーム中の重複した行	<A> . duplicated ( ) . sum ( )	pd . duplicated ( ) . sum ( )
<A> データフレーム中のカテゴリーを数値データで置き換える	pd . get_dummies ( <A> )	kind = <A> . get_dummies ( <A> )
<A> の中の未入力の値を <B> に置換した結果で置き換える	<A> = <A> . fillna ( <B> )	<B> <A> . fillna ( <B> , inplace = True )
<A> データフレームの <B> コラムをインデックスとして設定し、再代入する	<A> = <A> . set_index ( <B> )	plt . set_index ( <A> , <B> , inplace = True )
データフレーム <A> のインデックスをリセットした結果で置き換える	<A> = <A> . reset_index ( )	kind = <A> . reset_index ( )
コラム <C> で昇順にデータフレーム <B> をソートして、 <A> にする	<A> = <B> . sort_values ( <C> )	markerfacecolor = <B> . sort_values ( <C> )
<A> の <B> を欠損にした結果で置き換える	<A> = <A> . replace ( <B> , np . nan )	np . replace ( <A> , <B> , np . nan , inplace = True )
<A> データフレーム内の <B> コラムの重複している行を削除する	<A> . drop_duplicates ( subset = <B> )	<A> = <B> . drop_duplicates ( subset = <C> )
<A> 中の NaN を直前の行の値で補う	<A> . fillna ( method = 'ffill' )	<B> <A> . fillna ( method = 'ffill' )
エクセルファイル <B> を読み込み、データフレームに格納した結果を <A> に代入する	<A> = pd . read_excel ( <B> )	markerfacecolor = pd . read_excel ( <A> , <B> )
<A> と <B> の縦方向の棒グラフを棒グラフの位置を真ん中として表示する	plt . bar ( <A> , <B> , align = 'center' )	pd . bar ( <A> , <B> , align = 'center' )
エクセルファイル <B> から表データを読み込んで、 <A> に代入する	<A> = pd . read_excel ( <B> )	markerfacecolor = pd . read_excel ( <A> , <B> )
ある <C> を <B> の中に未記入の値とした結果を <A> にする	<A> = <B> . replace ( <C> , np . nan )	<B> <A> = <B> . replace ( <C> , np . nan )
データフレーム <A> 中に存在する <B> を欠損に置換して、置き換える	<A> . replace ( <B> , np . nan , inplace = True )	np . replace ( <A> , <B> , np . nan , inplace = True )
データフレーム <A> の列名を <B> から <C> にリネームする	<A> . rename ( columns = { <B> : <C> } )	} . rename ( columns = { <B> : <C> } )
エクセルファイル <B> にデータフレーム <A> を入れる	<A> . to_excel ( <B> )	to_excel . to_excel ( <A> , <B> )
<B> から <C> に <A> のインデックス名をリネームし、置き換える	<A> . rename ( index = { <B> : <C> } , inplace = True )	flush = <A> . rename ( index = { <B> : <C> } , inplace = True )
日付の形に <A> の <B> を変換する	pd . to_datetime ( <A> [ <B> ] )	range = ( <A> [ <B> ] )
データフレーム <B> の欠損値を <C> にされた結果を <A> にする	<A> = <B> . fillna ( <C> )	plt . fillna ( <A> , <B> , inplace = True )
一番左の列をインデックスとセットして、 <B> をデータフレームとして読み込まれた結果を <A> にする	<A> = pd . read_csv ( <B> , index_col = 0 )	markerfacecolor = pd . read_csv ( <A> , index_col = 0 )
エクセルファイル <B> のシート名 <C> から表を読み込み、 <A> とする	<A> = pd . read_excel ( <B> , sheet_name = <C> )	markerfacecolor = pd . read_excel ( <B> , sheet_name = <C> )
<B> の中にある <C> を未記入の値とした結果を <A> に代入する	<A> = <B> . replace ( <C> , np . nan )	<B> <A> = <B> . replace ( <C> , np . nan )
データフレーム <B> の未入力の値を <C> に変えた結果を <A> とする	<A> = <B> . fillna ( <C> )	markeredgecolor = <B> . fillna ( <C> )
<A> という名前のエクセルファイルの <B> シート名を表として読む	pd . read_excel ( <A> , sheet_name = <B> )	<A> . pd . read_excel ( <B> , sheet_name = <B> )
<A> の中の <B> のダブる行を落とされた結果を <A> とする	<A> = <A> . drop_duplicates ( subset = <B> )	mode = <A> . drop_duplicates ( subset = <B> )
<A> を <B> を使って昇順でソートする	<A> . sort_values ( <B> )	markerfacecolor = <A> . sort_values ( <B> )
データフレーム <A> 中にある <B> を NaN にし、再代入する	<A> = <A> . replace ( <B> , np . nan )	nan <A> = <A> . replace ( <B> , np . nan )
色をマゼンタとする	color = 'magenta'	markeredgecolor = 'magenta'
TF で重複があるのかどうかをデータフレーム <A> に返す	<A> . duplicated ( )	duplicated <A> . duplicated ( )
<C> から <D> に <B> のカラム名を変更された結果を <A> とする	<A> = <B> . rename ( columns = { <C> : <D> } )	} = { <B> . rename ( columns = { <C> : <D> } )
<B> データフレーム内の <C> コラムに重複がある行をドロップし、 <A> に代入する	<A> = <B> . drop_duplicates ( subset = <C> )	mode = <B> . drop_duplicates ( subset = <C> )
データフレーム <A> をカラム <B> と列 <C> を元に降順でソートする	<A> . sort_values ( [ <B> , <C> ] , ascending = False )	<B> <A> . sort_values ( [ <B> , <C> ] , ascending = False )
<A> 中の <B> に重複がある行を消して、 <A> にする	<A> = <A> . drop_duplicates ( subset = <B> )	markerfacecolor = <A> . drop_duplicates ( subset = <B> )
<A> データフレーム内の <B> 列と <C> 列に重複があるのかどうか確認する	<A> . duplicated ( subset = [ <B> , <C> ] )	alpha = <A> . duplicated ( subset = [ <B> , <C> ] )
プロットした図を <A> として出力する	plt . savefig ( <A> )	plt . bar ( <A> , <B> )
<B> の中の未入力の値を <C> で置き換えて、 <A> に代入する	<A> = <B> . fillna ( <C> )	markeredgecolor = <B> . fillna ( <C> )
六角形のマーカーの種類を使う	marker = 'h'	markerfacecolor = 'h'
<A> 中の <B> を未記入の値に置換し未記入の値がある行を落とす	<A> . replace ( <B> , np . nan ) . dropna ( )	replace <A> . replace ( <B> , np . nan ) . dropna ( )
<A> 中の未記入の値がある行を消して、 <A> とする	<A> = <A> . dropna ( )	marker = <A> . dropna ( )
データフレーム <A> 中にある <B> を NaN に置き換えた結果で書き換える	<A> . replace ( <B> , np . nan , inplace = True )	replace <A> . replace ( <B> , np . nan , inplace = True )
<A> データフレームの元のインデックスをリセットした結果を <A> とする	<A> = <A> . reset_index ( drop = True )	markeredgecolor = <A> . reset_index ( drop = True )
<A> の最初から <B> 行目までをチェックする	<A> [ : <B> ]	range = ( <A> [ <B> ] )
<A> を <B> と <C> を元に値が大きい順でソートする	<A> . sort_values ( [ <B> , <C> ] , ascending = False )	sort_values <A> . sort_values ( [ <B> , <C> ] , ascending = False )
<A> 内の欠損値を <B> で埋め、置き換える	<A> = <A> . fillna ( <B> )	<B> <A> . fillna ( <B> , inplace = True )
エクセルファイル <B> の全てのシートを読み込み、データフレームとして、 <A> とする	<A> = pd . read_excel ( <B> , sheet_name = None )	markerfacecolor = pd . read_excel ( <B> , sheet_name = None )
データフレーム <A> をインデックスに沿って昇順でソートして、置き換える	<A> = <A> . sort_index ( )	kind = <A> . sort_index ( )
データフレーム <A> 中に存在する <B> を欠損に置換して、置き換える	<A> = <A> . replace ( <B> , np . nan )	np . replace ( <A> , <B> , np . nan , inplace = True )
データフレーム <A> 中の NaN を直前の行の値で埋める	<A> . fillna ( method = 'ffill' )	<B> <A> . fillna ( method = 'ffill' )
<A> データフレームの <B> カラム、 <C> カラムを抽出する	<A> [ [ <B> , <C> ] ]	range = ( <A> [ <B> , <C> ] )
<A> データフレーム中の NaN を <B> に置換して、置き換える	<A> = <A> . fillna ( <B> )	flush = <A> . fillna ( <B> )
データフレーム <A> の中の未入力の値を <B> に置換して、置き換える	<A> . fillna ( <B> , inplace = True )	flush = <A> . fillna ( <B> )
存在する <C> を <B> データフレーム中に NaN に置換し、 <A> とする	<A> = <B> . replace ( <C> , np . nan )	<B> <A> = <B> . replace ( <C> , np . nan )
データフレーム <B> をインデックスにそって昇順でソートした結果を <A> にする	<A> = <B> . sort_index ( )	markerfacecolor = <B> . sort_index ( )
ある <B> をデータフレーム <A> の中に未入力の値で補われた、結果で置き換える	<A> . replace ( <B> , np . nan , inplace = True )	np . replace ( <A> , <B> , np . nan , inplace = True )
<A> 内の欠損がある行を削除し、置き換える	<A> = <A> . dropna ( )	dropna = <A> . dropna ( )
ある行を <B> 中の未記入の値が消された結果を <A> とする	<A> = <B> . dropna ( )	dropna <A> = <B> . dropna ( )
タブ区切りで <B> データを読んで、 <A> にする	<A> = pd . read_csv ( <B> , sep = '\t' )	plt . read_csv ( <A> , sep = '\t' )
<A> の <B> を区関数を <C> 、ビンのラベルを <D> として分割する	pd . cut ( <A> [ <B> ] , <C> , label = <D> )	<A> = pd . cut ( <B> [ <C> ] , <D> , label = <E> )
<B> 全体をインデックスを元に小さい順でソートし、 <A> とする	<A> = <B> . sort_index ( )	markerfacecolor = <B> . sort_index ( )
<A> データフレームをインデックスで値が小さい順に並び替えた結果で置き換える	<A> = <A> . sort_index ( )	kind = <A> . sort_index ( )
グラフの y 軸を <A> とした <B> の横方向の棒グラフを描写する	plt . barh ( <A> , <B> )	<A> = plt . barh ( <B> )
データフレーム <B> の中の未記入の値を落として、 <A> に代入する	<A> = <B> . dropna ( )	dropna <A> = <B> . dropna ( )
<A> の中のそれぞれの列に存在する <B> の数の合計値	<A> . isin ( [ <B> ] ) . sum ( )	isin <A> = <B> . isin ( [ <C> ] ) . sum ( )
グラフ種類はグラフを用いる	kind = 'line'	stacked = 'line'
<A> データフレームの中にある <B> を未入力の値に置き換え、 <A> に代入する	<A> = <A> . replace ( <B> , np . nan )	nan <A> = <A> . replace ( <B> , np . nan )
ある行を <A> データフレーム内の NaN がドロップする	<A> . dropna ( )	pd . dropna ( )
<A> データフレーム全体を <B> カラムと <C> 列に基づいて降順でソートした結果で置き換える	<A> . sort_values ( [ <B> , <C> ] , ascending = False , inplace = True )	flush = <A> . sort_values ( [ <B> , <C> ] , ascending = False , inplace = True )
<A> データフレームをインデックスを元に小さい方からソートした結果で置き換える	<A> . sort_index ( inplace = True )	kind = <A> . sort_index ( )
<A> データフレーム中に欠損があるか数える	<A> . isnull ( ) . sum ( )	isnull <A> . isnull ( ) . sum ( )
<A> データフレームの NaN を <B> にして、置き換える	<A> = <A> . fillna ( <B> )	flush = <A> . fillna ( <B> )
<B> の <C> を区間を <D> 、ビンの名前をインデックスとして分割して、 <A> に代入する	<A> = pd . cut ( <B> [ <C> ] , <D> , label = False )	[ <A> = pd . cut ( <B> [ <C> ] , <D> , label = False )
データフレーム <B> の中にある <C> を未記入の値で埋め、 <A> にする	<A> = <B> . replace ( <C> , np . nan )	<B> <A> = <B> . replace ( <C> , np . nan )
表を CSV データ <A> からタブ区切りで読み込む	pd . read_csv ( <A> , sep = '\t' )	sep = pd . read_csv ( <A> , sep = '\t' )
<B> をインデックスどおりに昇順でソートし、 <A> にする	<A> = <B> . sort_index ( )	sort_index <A> = <B> . sort_index ( )
データフレーム <A> をインデックスで並び替え、再代入する	<A> = <A> . sort_index ( )	sort_index = <A> . sort_index ( )
<B> 番目の列をインデックスに指定して、 <A> データを読む	pd . read_csv ( <A> , index_col = <B> )	index_col pd . read_csv ( <A> , index_col = <B> , index_col = <B> )
マーカーの形の色は黄緑色を使用する	markerfacecolor = 'greenyellow'	markeredgecolor = 'greenyellow'
<A> データフレームの中の <B> コラムのダブる行を落とされた結果を <A> にする	<A> = <A> . drop_duplicates ( subset = <B> )	mode = <A> . drop_duplicates ( subset = <B> )
<A> データフレームをインデックスに基づき昇順でソートして、 <A> にする	<A> = <A> . sort_index ( )	sort_index = <A> . sort_index ( )
<A> 内の <B> に重複がある行を削除した結果を再代入する	<A> = <A> . drop_duplicates ( subset = <B> )	markerfacecolor = <A> . drop_duplicates ( subset = <B> )
データフレーム <A> 全体をインデックスで昇順にソートし、インプレースする	<A> . sort_index ( inplace = True )	sort_index = <A> . sort_index ( )
カラム <B> と列 <C> を軸にデータフレーム <A> を逆順でソートして、 <A> に代入する	<A> = <A> . sort_values ( [ <B> , <C> ] , ascending = False )	[ <A> = <A> . sort_values ( [ <B> , <C> ] , ascending = False )
エクセルファイル <B> の <C> を読み込み、データフレームにし、 <A> にする	<A> = pd . read_excel ( <B> , sheet_name = <C> )	marker = pd . read_excel ( <B> , sheet_name = <C> )
<B> の <C> をダミー変数化して、 <A> に代入する	<A> = pd . get_dummies ( <B> [ <C> ] )	autopct = pd . get_dummies ( <B> [ <C> ] )
<A> データフレーム中の NaN を <B> に置換する	<A> . fillna ( <B> )	fillna <A> . fillna ( <B> )
データフレーム <A> 内の欠損値をドロップし、 <A> に代入する	<A> = <A> . dropna ( )	nan = <A> . dropna ( )
真ん中として <A> と <B> の縦向き棒グラフを棒グラフの位置をプロットする	plt . bar ( <A> , <B> , align = 'center' )	bar plt . bar ( <A> , <B> , align = 'center' )
エクセルファイル <A> の <B> 番目のシートから読む	pd . read_excel ( <A> , sheet_name = <B> )	sheet_name = pd . read_excel ( <A> , sheet_name = <B> )
<B> カラムと <C> 列を軸に <A> データフレームを逆順でソートする	<A> . sort_values ( [ <B> , <C> ] , ascending = False )	ascending . sort_values ( [ <A> [ <B> ] , <C> ] , ascending = False )
マーカーの形を十字とする	marker = 'x'	markerfacecolor = 'x'
データフレーム <B> 内に存在する <C> を欠損にした結果を <A> にする	<A> = <B> . replace ( <C> , np . nan )	replace <A> = <B> . replace ( <C> , np . nan )
ある <B> を <A> の中に未入力の値に置き換えた結果でインプレースする	<A> . replace ( <B> , np . nan , inplace = True )	replace <A> . replace ( <B> , np . nan , inplace = True )
<A> の中の未記入の値を <B> で置き換える	<A> . fillna ( <B> )	plt . fillna ( <A> [ <B> ] )
( <A> [ <B> ] ) の平均値をチェックする	<A> [ <B> ] . mean ( )	[ <A> [ <B> ] . mean ( )
エクセルファイル <A> を読み込み、表データに格納する	pd . read_excel ( <A> )	start = pd . read_excel ( <A> )
エクセルファイル <A> の <B> を表とする	pd . read_excel ( <A> , sheet_name = <B> )	<A> . pd . read_excel ( <B> , sheet_name = <B> )
<B> から <C> に <A> のインデックス名をリネームした結果を <A> とする	<A> = <A> . rename ( index = { <B> : <C> } )	<B> <A> . rename ( index = { <B> : <C> } , inplace = True )
目印を十字とする	marker = 'x'	to_excel = 'x'
<B> の <C> についてダミー変数を作って、 <A> とする	<A> = pd . get_dummies ( <B> [ <C> ] )	markeredgecolor = pd . get_dummies ( <B> [ <C> ] )
点のマーカーの形状を用いる	marker = '.'	autopct = '.'
エンコーディングをシフト JIS として、データ <A> を読む	pd . read_csv ( <A> , encoding = 'shift_jis' )	<A> . pd . read_csv ( <B> , encoding = 'shift_jis' )
データフレーム <A> のカラム <B> 、カラム <C> を選ぶ	<A> [ [ <B> , <C> ] ]	plt . plot ( <A> [ <B> , <C> ] )
重複する最後の行を残して <A> データフレーム中の重複している行を消す	<A> . drop_duplicates ( keep = False )	<B> <A> . drop_duplicates ( keep = False )
インデックスを軸に <A> データフレームを昇順でソートした結果を <A> にする	<A> = <A> . sort_index ( )	sort_index = <A> . sort_index ( )
打点を×とする	marker = 'x'	markerfacecolor = 'x'
データフレーム <A> 中の <B> を NaN に変え NaN が存在する行を消された結果で置き換える	<A> = <A> . replace ( <B> , np . nan ) . dropna ( )	<A> . replace ( <B> , np . nan ) . dropna ( inplace = True )
表示する行数を最大 <A> に設定する	pd . set_option ( 'display.max_rows' , <A> )	alpha = pd . set_option ( 'display.max_rows' , <A> )
<B> データフレームについてダミー変数をつくられた結果を <A> とする	<A> = pd . get_dummies ( <B> )	markerfacecolor = pd . get_dummies ( <A> , <B> )
<B> データフレームをインデックスで昇順にソートして、 <A> に代入する	<A> = <B> . sort_index ( )	markerfacecolor = <B> . sort_index ( )
列番号 <B> をインデックスとして、 <A> を表データとして読む	pd . read_csv ( <A> , index_col = <B> )	<A> . pd . read_csv ( <B> , index_col = <C> )
データフレーム <B> のコラム <C> を分割数を <D> として分割した結果を <A> とする	<A> = pd . cut ( <B> [ <C> ] , <D> )	[ <A> = pd . cut ( <B> [ <C> ] , <D> )
<A> データフレーム中の重複している行を削除された結果で置き換える	<A> . drop_duplicates ( inplace = True )	<A> = <A> . drop_duplicates ( )
データフレーム <B> 内のカテゴリ変数を one - hot 表現にし、 <A> に代入する	<A> = pd . get_dummies ( <B> )	markerfacecolor = pd . get_dummies ( <A> , <B> )
<B> についてダミー変数を作り、 <A> に代入する	<A> = pd . get_dummies ( <B> )	markerfacecolor = pd . get_dummies ( <A> , <B> )
<A> データフレーム中にある <B> を未記入の値で置き換えて、再代入する	<A> = <A> . replace ( <B> , np . nan )	nan <A> = <A> . replace ( <B> , np . nan )
<A> データフレームの <B> を欠損値で埋めた結果を再代入する	<A> = <A> . replace ( <B> , np . nan )	nan <A> = <A> . replace ( <B> , np . nan )
<B> から表を <C> 区切りで読み、 <A> とする	<A> = pd . read_csv ( <B> , sep = <C> )	pd . read_csv ( <A> , sep = <B> )
<A> の中の欠損が存在する行を取り除き、置き換える	<A> = <A> . dropna ( )	dropna = <A> . dropna ( )
<A> の中の重複要素がある行を落として、置き換える	<A> = <A> . drop_duplicates ( )	kind = <A> . drop_duplicates ( )
エクセルファイル <B> の <C> シート名を読み込み、表データに格納して、 <A> に代入する	<A> = pd . read_excel ( <B> , sheet_name = <C> )	markerfacecolor = pd . read_excel ( <B> , sheet_name = <C> )
<A> と <B> を <C> 色の折れ線グラフで表示する	plt . plot ( <A> , <B> , color = <C> )	sns . plot ( <A> , <B> , color = <C> )
<A> データフレームの中にある <B> を未入力の値で補った結果で置き換える	<A> = <A> . replace ( <B> , np . nan )	np . replace ( <A> , <B> , np . nan , inplace = True )
<A> データフレーム内の欠損値を <B> に置換して、置き換える	<A> . fillna ( <B> , inplace = True )	<A> = <A> . fillna ( <B> )
<A> の中の未入力の値がある行を落とした結果で置き換える	<A> = <A> . dropna ( )	dropna = <A> . dropna ( )
<A> データフレーム中の <B> コラムの重複している行を削除した結果を再代入する	<A> = <A> . drop_duplicates ( subset = <B> )	plt . drop_duplicates ( subset = <A> , <B> , inplace = True )
<B> というファイル名でエクセルに <A> を書き出す	<A> . to_excel ( <B> )	markerfacecolor = <A> . to_excel ( <B> )
データフレーム <A> をコラム <B> と列 <C> が値の大きい順になるようにソートして、置き換える	<A> . sort_values ( [ <B> , <C> ] , ascending = False , inplace = True )	flush = <A> . sort_values ( [ <B> , <C> ] , ascending = False , inplace = True )
データフレーム <A> 内のカラムに存在する <B> の個数の和を表示する	<A> . isin ( [ <B> ] ) . sum ( )	isin <A> [ <B> ] . sum ( )
グラフカラーを赤紫色とする	color = 'magenta'	markerfacecolor = 'magenta'
<A> と <B> に対して <C> をキーとしてデータをマージする	pd . merge ( <A> , <B> , on = <C> )	on = pd . merge ( <A> , <B> , on = <C> )
<B> 内の欠損を <C> で埋めた結果を <A> に代入する	<A> = <B> . fillna ( <C> )	plt . fillna ( <A> , <B> , inplace = True )
データフレーム <A> の数値じゃないデータを数値データにする	pd . get_dummies ( <A> )	start = pd . get_dummies ( <A> )
線グラフの種類は棒グラフを用いる	kind = 'barh'	linestyle = 'bar'
<B> データフレーム全体をインデックスを元に昇順でソートして、 <A> にする	<A> = <B> . sort_index ( )	markerfacecolor = <B> . sort_index ( )
列番号 <C> をインデックスとセットして <B> から表データを読んだ結果を <A> にする	<A> = pd . read_csv ( <B> , index_col = <C> )	index_col <A> = pd . read_csv ( <B> , index_col = <C> )
<A> 内の欠損値をドロップする	<A> . dropna ( )	np . dropna ( )
<B> コラムと <C> 列が値の大きい順になるように <A> データフレームをソートした結果を <A> にする	<A> = <A> . sort_values ( [ <B> , <C> ] , ascending = False )	[ <A> = <A> . sort_values ( [ <B> , <C> ] , ascending = False )
ビンを <C> として <A> データフレームの <B> コラムを分割する	pd . cut ( <A> [ <B> ] , <C> )	<A> = pd . cut ( <B> [ <C> ] , <D> )
<A> 中の <B> を未記入の値に変え未記入の値がある行を落とす	<A> . replace ( <B> , np . nan ) . dropna ( )	replace <A> . replace ( <B> , np . nan ) . dropna ( )
<B> データフレームの NaN がある行を消して、 <A> とする	<A> = <B> . dropna ( )	errors = <B> . dropna ( )
<A> 内のそれぞれのカラムに存在する <B> の合計を見る	<A> . isin ( [ <B> ] ) . sum ( )	isin <A> = <B> . isin ( [ <C> ] ) . sum ( )
データフレーム <B> 中の欠損を <C> で埋めた結果を <A> に代入する	<A> = <B> . fillna ( <C> )	markeredgecolor = <B> . fillna ( <C> )
<A> の <B> と <C> を選ぶ	<A> [ [ <B> , <C> ] ]	plt . plot ( <A> [ <B> , <C> ] )
<B> 内の NaN が存在する行をドロップされた結果を <A> とする	<A> = <B> . dropna ( )	dropna <A> = <B> . dropna ( )
<A> データフレーム中のそれぞれのコラムにある <B> の個数の和	<A> . isin ( [ <B> ] ) . sum ( )	isin <A> = <B> . isin ( [ <C> ] ) . sum ( )
<A> データフレームをインデックスで昇順にソートし、置き換える	<A> . sort_index ( inplace = True )	kind = <A> . sort_index ( )
データフレーム <A> 内のインデックスが <B> の行	<A> . loc [ <B> ]	<A> . set_index ( <B> )
データフレーム <A> のコラム <B> をビンを <C> 、ビンのラベルをリスト <D> として分割する	pd . cut ( <A> [ <B> ] , <C> , label = <D> )	<A> = pd . cut ( <B> [ <C> ] , <D> , label = <E> )
エクセルファイル <B> のシート名 <C> を指定して読んだ結果を <A> にする	<A> = pd . read_excel ( <B> , sheet_name = <C> )	markerfacecolor = pd . read_excel ( <B> , sheet_name = <C> )
データフレーム <A> の <B> を NaN で補った結果を <A> にする	<A> = <A> . replace ( <B> , np . nan )	nan <A> = <A> . replace ( <B> , np . nan )
円のマーカーの形状を使用する	marker = 'o'	markerfacecolor = 'o'
<A> の <C> に <B> の名前を <E> に <D> の名前をリネームした結果で書き換える	<A> . rename ( columns = { <B> : <C> , <D> : <E> } , inplace = True )	<B> <A> . rename ( columns = { <C> : <D> , <E> : <F> } , inplace = True )
打点の色は紫を適用する	markerfacecolor = 'purple'	marker = 'purple'
データフレーム <B> 中にある <C> を未記入の値にした結果を <A> とする	<A> = <B> . replace ( <C> , np . nan )	<B> <A> = <B> . replace ( <C> , np . nan )
<A> と <B> のグラフを RGBc で描写する	plt . plot ( <A> , <B> , color = c )	<A> . plt . plot ( <B> , color = c )
データフレーム <A> 中の未記入の値を <B> に置換し、置き換える	<A> . fillna ( <B> , inplace = True )	<B> <A> . fillna ( <B> , inplace = True )
<A> の欠損値を <B> にして、再代入する	<A> = <A> . fillna ( <B> )	plt . fillna ( <A> , <B> , inplace = True )
データフレーム <A> のカラム <B> を datetime 型に変換する	pd . to_datetime ( <A> [ <B> ] )	range = ( <A> [ <B> ] )
<B> 全体を <C> に基づいて昇順でソートし、 <A> とする	<A> = <B> . sort_values ( <C> )	markerfacecolor = <B> . sort_values ( <C> )
データフレーム <A> の <B> を NaN とし、 <A> に代入する	<A> = <A> . replace ( <B> , np . nan )	nan <A> = <A> . replace ( <B> , np . nan )
<A> データフレーム中の NaN を含む行を消し、再代入する	<A> = <A> . dropna ( )	marker = <A> . dropna ( )
<A> 全体をインデックスで昇順にソートした結果を再代入する	<A> = <A> . sort_index ( )	markerfacecolor = <A> . sort_index ( )
<A> データフレームの <B> インデックスの名前を <C> にリネームして、 <A> とする	<A> = <A> . rename ( index = { <B> : <C> } )	<B> <A> . rename ( index = { <B> : <C> } , inplace = True )
<A> データフレームの行の名前を <B> から <C> にリネームする	<A> . rename ( index = { <B> : <C> } )	<B> <A> . rename ( index = { <B> : <C> } )
<A> 中のダブる行を落とした結果で置き換える	<A> = <A> . drop_duplicates ( )	kind = <A> . drop_duplicates ( )
<B> という名前のエクセルファイルとして <A> を保存する	<A> . to_excel ( <B> )	plt . to_excel ( <A> , <B> )
<A> の中の列それぞれにある <B> の数の和	<A> . isin ( [ <B> ] ) . sum ( )	isin <A> = <B> . isin ( [ <C> ] ) . sum ( )
凡例をグラフ内に入れる	plt . legend ( )	<A> . isnull ( ) . sum ( )
<A> データフレーム内に存在する <B> を欠損で置換した結果でインプレースする	<A> . replace ( <B> , np . nan , inplace = True )	replace <A> . replace ( <B> , np . nan , inplace = True )
データフレーム <A> 中の重複要素がある行を消し、 <A> に代入する	<A> = <A> . drop_duplicates ( )	xticks <A> = <A> . drop_duplicates ( )
データフレーム <A> 内のコラム <B> の重複した行をドロップして、 <A> とする	<A> = <A> . drop_duplicates ( subset = <B> )	markerfacecolor = <A> . drop_duplicates ( subset = <B> )
データフレーム <A> の列 <B> とコラム <C> を降順にソートされた結果で置き換える	<A> . sort_values ( [ <B> , <C> ] , ascending = False , inplace = True )	flush = <A> . sort_values ( [ <B> , <C> ] , ascending = False , inplace = True )
エクセルファイル <B> のシート名 <C> を読んで、 <A> にする	<A> = pd . read_excel ( <B> , sheet_name = <C> )	markerfacecolor = pd . read_excel ( <B> , sheet_name = <C> )
ある行をデータフレーム <A> の中の未入力の値が落として、置き換える	<A> = <A> . dropna ( )	kind = <A> . dropna ( )
<B> 中の <C> に重複がある行を削除された結果を <A> とする	<A> = <B> . drop_duplicates ( subset = <C> )	markerfacecolor = <B> . drop_duplicates ( subset = <C> )
<A> データフレーム内に重複があるのかどうか検出	<A> . duplicated ( )	duplicated <A> . duplicated ( )
ダブる最後の行を残してデータフレーム <B> の中の重複している行を落として、 <A> にする	<A> = <B> . drop_duplicates ( keep = False )	markeredgecolor = <B> . drop_duplicates ( keep = False )
<A> データフレームの <B> カラム、 <C> カラムを選択する	<A> [ [ <B> , <C> ] ]	range = ( <A> [ <B> , <C> ] )
<A> データフレームの <B> コラムを区間を <C> 、ビンのラベルを <D> リストとして分割する	pd . cut ( <A> [ <B> ] , <C> , label = <D> )	<A> = pd . cut ( <B> [ <C> ] , <D> , label = <E> )
データフレーム <A> 中の <B> , <C> , <D> 行目の <E> , <C> 列目をえる	<A> . iloc [ [ <B> , <C> , <D> ] , [ <E> , <C> ] ]	pd . cut ( <A> [ <B> ] , <C> , label = <D> )
グラフ名を <A> に設定する	plt . title ( <A> )	title plt . title ( <A> )
<A> データフレーム内のそれぞれのカラムにある <B> の個数	<A> . isin ( [ <B> ] ) . sum ( )	isin <A> [ <B> ] . sum ( )
データフレーム <A> のインデックス名を <B> から <C> にリネームして、 <A> とする	<A> = <A> . rename ( index = { <B> : <C> } )	<B> <A> . rename ( index = { <B> : <C> } , inplace = True )
インデックスを軸に <A> データフレームを昇順でソートして、再代入する	<A> = <A> . sort_index ( )	sort_index = <A> . sort_index ( )
データフレーム <B> とデータフレーム <C> を横方向にマージして、 <A> にする	<A> = pd . merge ( <B> , <C> )	pd . merge ( <A> , <B> , on = <C> )
インデックスを元にデータフレーム <B> をソートした結果を <A> とする	<A> = <B> . sort_index ( )	markerfacecolor = <B> . sort_index ( )
目印の色を紫とする	markerfacecolor = 'purple'	marker = 'purple'
カラム <B> と列 <C> でデータフレーム <A> 全体を逆順にソートした結果で置き換える	<A> = <A> . sort_values ( [ <B> , <C> ] , ascending = False )	flush = <A> . sort_values ( [ <B> , <C> ] , ascending = False , inplace = True )
<A> の <B> と <C> をドロップして、 <A> とする	<A> = <A> . drop ( [ <B> , <C> ] , axis = 1 )	plt . plot ( <A> , <B> , axis = 1 , inplace = True )
<C> に <A> データフレームの <B> インデックスの名前をリネームし、 <A> にする	<A> = <A> . rename ( index = { <B> : <C> } )	<B> <A> . rename ( index = { <B> : <C> } , inplace = True )
データフレーム <A> の先頭 5 行	<A> . head ( )	<A> . tail ( )
エクセルファイル <B> から表を読み込んだ結果を <A> に代入する	<A> = pd . read_excel ( <B> )	markerfacecolor = pd . read_excel ( <A> , <B> )
マーカーの形状を星とする	marker = '*'	alpha = '*'
<A> データフレームを <B> コラムで昇順にソートした結果で置き換える	<A> = <A> . sort_values ( <B> )	<A> . sort_values ( <B> , inplace = True )
○の打点を適用する	marker = 'o'	markerfacecolor = 'o'
データフレーム <A> をインデックスで順番になるようにソートする	<A> . sort_index ( )	pd . sort_index ( )
データフレーム <A> のカラム名を <B> から <C> にし、置き換える	<A> . rename ( columns = { <B> : <C> } , inplace = True )	<B> <A> . rename ( columns = { <B> : <C> } , inplace = True )
<B> データフレームの <C> を未記入の値で置き換え、 <A> に代入する	<A> = <B> . replace ( <C> , np . nan )	<B> <A> = <B> . replace ( <C> , np . nan )
<A> データフレームを <B> というファイル名でエクセル形式で保存する	<A> . to_excel ( <B> )	range = ( <A> [ <B> ] )
<A> データから表データをタブ区切りで読む	pd . read_csv ( <A> , sep = '\t' )	sep = pd . read_csv ( <A> , sep = '\t' )
エクセルファイル <B> の <C> 番目のシートから読み込んで、 <A> とする	<A> = pd . read_excel ( <B> , sheet_name = <C> )	markerfacecolor = pd . read_excel ( <B> , sheet_name = <C> )
データフレーム <A> 中の NaN をデータフレーム <A> の平均をとって補った結果で置き換える	<A> = <A> . fillna ( <A> . mean ( ) )	kind = <A> . fillna ( <A> . mean ( ) )
<B> データフレームの <C> カラムをインデックス、 <D> カラムをコラムとしたピボットテーブルを作成し、 <A> とする	<A> = <B> . pivot_table ( index = <C> , columns = <D> )	plt . plot ( <A> , <B> , left_index = True , right_on = <C> )
凡例をグラフ内に追加する	plt . legend ( )	<A> = pd . legend ( )
マーカーの形状の輪郭線の幅は <A> を用いる	markeredgewidth = <A>	range = ( <A> , <B> )
<A> データフレームを <B> コラムと <C> 列が値の大きい順になるようにソートする	<A> . sort_values ( [ <B> , <C> ] , ascending = False )	sort_values <A> . sort_values ( [ <B> , <C> ] , ascending = False )
データフレーム <A> の中にある <B> を未入力の値に置き換えられた結果で置き換える	<A> = <A> . replace ( <B> , np . nan )	np . replace ( <A> , <B> , np . nan , inplace = True )
<A> の <B> を欠損値に置換して、置き換える	<A> = <A> . replace ( <B> , np . nan )	np . replace ( <A> , <B> , np . nan , inplace = True )
<A> 中にある <B> を NaN で埋め、書き換える	<A> . replace ( <B> , np . nan , inplace = True )	replace <A> . replace ( <B> , np . nan , inplace = True )
データフレーム <A> 中の NaN を消す	<A> . dropna ( )	plt . dropna ( )
<A> データフレーム中の未記入の値を落とす	<A> . dropna ( )	plt . dropna ( )
エクセルファイル <A> の全てのシートを表データに読む	pd . read_excel ( <A> , sheet_name = None )	kind = pd . read_excel ( <A> , sheet_name = None )
存在する <B> を <A> データフレーム内に欠損値とした結果を <A> とする	<A> = <A> . replace ( <B> , np . nan )	nan <A> = <A> . replace ( <B> , np . nan )
列番号 <B> をインデックスと <A> データから表を読む	pd . read_csv ( <A> , index_col = <B> )	<A> . pd . read_csv ( <B> , index_col = <C> )
<A> 番まで行を表示できるように設定する	pd . set_option ( 'display.max_rows' , <A> )	alpha = pd . set_option ( 'display.max_rows' , <A> )
コラム <B> で昇順にデータフレーム <A> をソートして、置き換える	<A> . sort_values ( <B> , inplace = True )	<A> = <A> . sort_values ( <B> )
<A> の中の未記入の値を <B> で埋めた結果で置き換える	<A> = <A> . fillna ( <B> )	<B> <A> . fillna ( <B> , inplace = True )
エクセルファイル <B> の <C> シート名を表データに格納した結果を <A> とする	<A> = pd . read_excel ( <B> , sheet_name = <C> )	markerfacecolor = pd . read_excel ( <B> , sheet_name = <C> )
目印の色を黄色とする	markerfacecolor = 'yellow'	markeredgecolor = 'yellow'
データフレーム <A> 中の NaN を直前の行の値で埋めた結果で置き換える	<A> . fillna ( method = 'ffill' , inplace = True )	<B> <A> . fillna ( method = 'ffill' , inplace = True )
<A> 中の欠損を含む行を削除する	<A> . dropna ( )	plt . dropna ( )
<A> データフレームの <B> を欠損にし、 <A> に代入する	<A> = <A> . replace ( <B> , np . nan )	nan <A> = <A> . replace ( <B> , np . nan )
重複する最後の行を残して <B> 中の重複している行を消された結果を <A> に代入する	<A> = <B> . drop_duplicates ( keep = False )	markeredgecolor = <B> . drop_duplicates ( keep = False )
<A> データフレームのオブジェクトデータの統計情報を見る	<A> . describe ( include = 'O' )	<B> <A> . describe ( include = 'O' )
<A> 中の欠損を直前の行の値で埋め、置き換える	<A> . fillna ( method = 'ffill' , inplace = True )	<B> <A> . fillna ( method = 'ffill' , inplace = True )
CSV ファイル <A> を表データとして読み込む	pd . read_csv ( <A> )	kind = pd . read_csv ( <A> )
<B> をインデックスを軸に小さい順にソートされた結果を <A> とする	<A> = <B> . sort_index ( )	) <A> = <B> . sort_index ( )
y 軸を <A> として <B> の横方向の棒グラフを表示する	plt . barh ( <A> , <B> )	plt . barh ( <A> , <B> , align = 'center' )
<A> データフレーム中の欠損を <B> とする	<A> . fillna ( <B> )	pd . fillna ( <A> , <B> )
カラム <B> と列 <C> を元にデータフレーム <A> 全体を降順でソートし、 <A> とする	<A> = <A> . sort_values ( [ <B> , <C> ] , ascending = False )	[ <A> = <A> . sort_values ( [ <B> , <C> ] , ascending = False )
<B> という名前のエクセルファイルの全てのシートをデータフレームとして読んだ結果を <A> にする	<A> = pd . read_excel ( <B> , sheet_name = None )	errors = pd . read_excel ( <B> , sheet_name = None )
エクセルファイル <B> の <C> 番目のシートを読み込み、データフレームにし、 <A> とする	<A> = pd . read_excel ( <B> , sheet_name = <C> )	marker = pd . read_excel ( <B> , sheet_name = <C> )
<A> の中の <B> と <C> に重複があるのかどうか確認を表示する	<A> . duplicated ( subset = [ <B> , <C> ] )	<B> <A> . duplicated ( subset = [ <C> ] )
<A> の <B> を未記入の値で補い、置き換える	<A> = <A> . replace ( <B> , np . nan )	np . replace ( <A> , <B> , np . nan , inplace = True )
<A> をインデックスどおりに昇順でソートし、置き換える	<A> . sort_index ( inplace = True )	kind = <A> . sort_index ( )
エクセルファイル <B> の <C> 番目のシートを読み込み、データフレームに格納した結果を <A> にする	<A> = pd . read_excel ( <B> , sheet_name = <C> )	marker = pd . read_excel ( <B> , sheet_name = <C> )
<A> 全体を <B> と <C> を軸に降順でソートし、再代入する	<A> = <A> . sort_values ( [ <B> , <C> ] , ascending = False )	[ <A> = <A> . sort_values ( [ <B> , <C> ] , ascending = False )
<A> データフレーム中の <B> を NaN に変え NaN がある行を消して、置き換える	<A> = <A> . replace ( <B> , np . nan ) . dropna ( )	<A> . replace ( <B> , np . nan ) . dropna ( inplace = True )
<B> 全体を <C> を軸に昇順でソートした結果を <A> に代入する	<A> = <B> . sort_values ( <C> )	markerfacecolor = <B> . sort_values ( <C> )
データフレーム <A> 全体をインデックスで順にソートした結果で置き換える	<A> = <A> . sort_index ( )	kind = <A> . sort_index ( )
ある <B> を <A> 中に未記入の値にした結果で置き換える	<A> = <A> . replace ( <B> , np . nan )	np . replace ( <A> , <B> , np . nan , inplace = True )
グラフ幅を <C> として <A> 座標を <A> とした <B> の棒グラフを表示する	plt . bar ( <A> , <B> , width = <C> )	bar plt . bar ( <A> , <B> , width = <C> )
<B> データフレーム中の <C> コラムの重複している行を削除し、 <A> とする	<A> = <B> . drop_duplicates ( subset = <C> )	markeredgecolor = <B> . drop_duplicates ( subset = <C> )
コラム <B> と列 <C> が降順になるようにデータフレーム <A> 全体をソートされた結果を再代入する	<A> = <A> . sort_values ( [ <B> , <C> ] , ascending = False )	[ <A> = <A> . sort_values ( [ <B> , <C> ] , ascending = False )
<A> 中のコラムそれぞれに存在する <B> の個数の合計値	<A> . isin ( [ <B> ] ) . sum ( )	isin <A> = <B> . isin ( [ <C> ] ) . sum ( )
データフレーム <A> のカラム <B> とコラム <C> とカラム <D> を抽出する	<A> [ [ <B> , <C> , <D> ] ]	<B> <A> . drop ( [ <B> , <C> , <D> ] , [ <E> , <C> ] ] )
<A> において <B> と <C> と <D> の関係性を一気にプロットする	sns . pairplot ( <A> [ [ <B> , <C> , <D> ] ] )	<A> . groupby ( [ <B> , <C> ] ) [ <D> ] . sum ( )
データフレーム <A> をコラム <B> と列 <C> が降順になるようにソートする	<A> . sort_values ( [ <B> , <C> ] , ascending = False )	<B> <A> . sort_values ( [ <B> , <C> ] , ascending = False )
<A> の <B> をビンを <C> として分割する	pd . cut ( <A> [ <B> ] , <C> )	<A> = pd . cut ( <B> [ <C> ] , <D> )
先頭の列をインデックスと設定して、 <B> データを表として読んだ結果を <A> とする	<A> = pd . read_csv ( <B> , index_col = 0 )	0 = pd . read_csv ( <A> , index_col = 0 )
存在する行をデータフレーム <A> の中の未記入の値が取り除き、 <A> に代入する	<A> = <A> . dropna ( )	errors = <A> . dropna ( )
<A> データフレームの <B> コラムをインデックスとして設定した結果を <A> にする	<A> = <A> . set_index ( <B> )	plt . set_index ( <A> , <B> , align = True )
<A> 内の欠損値を <B> で埋める	<A> . fillna ( <B> )	fillna <A> . fillna ( <B> )
軸を <A> として <B> の水平棒グラフを描写する	plt . barh ( <A> , <B> , align = 'center' )	barh plt . barh ( <A> , <B> , align = 'center' )
<B> データフレーム内の重複要素がある行をドロップした結果を <A> にする	<A> = <B> . drop_duplicates ( )	mode = <B> . drop_duplicates ( )
<A> データフレームの中の欠損がある行を取り除き、置き換える	<A> = <A> . dropna ( )	dropna = <A> . dropna ( )
マーカーの形をアスタリスクとする	marker = '*'	markerfacecolor = '*'
存在する <B> を <A> データフレーム内に欠損値に置換して、置き換える	<A> = <A> . replace ( <B> , np . nan )	np . replace ( <A> , <B> , np . nan , inplace = True )
データフレーム <A> 全体をカラム <B> と列 <C> で逆順にソートする	<A> . sort_values ( [ <B> , <C> ] , ascending = False )	sort_values <A> . sort_values ( [ <B> , <C> ] , ascending = False )
エクセルファイル <B> の全てのシートを読み込み、データフレームに格納された結果を <A> とする	<A> = pd . read_excel ( <B> , sheet_name = None )	markerfacecolor = pd . read_excel ( <B> , sheet_name = None )
データフレーム <A> のカラム <B> と列 <C> ごとのコラム <D> の値の合計値を計算する	<A> . groupby ( [ <B> , <C> ] ) [ <D> ] . sum ( )	<B> <A> = <B> . groupby ( [ <C> , <D> ] ) . sum ( )
<A> データフレーム中の重複している行を削除して、 <A> とする	<A> = <A> . drop_duplicates ( )	<A> = pd . drop_duplicates ( )
リトルエンディアンを用いる	byteorder = 'little'	buffering = 'horizontal'
グラフカラーを青とする	color = 'blue'	markeredgecolor = 'blue'
存在する <B> を <A> 中に NaN で置換して、 <A> とする	<A> = <A> . replace ( <B> , np . nan )	nan <A> = <A> . replace ( <B> , np . nan )
<A> データフレーム中の未記入の値を <B> に置き換えて、再代入する	<A> = <A> . fillna ( <B> )	plt . fillna ( <A> , <B> , inplace = True )
<A> データフレームの行の重複を確認	<A> . duplicated ( )	duplicated <A> . duplicated ( )
インデックスを元にデータフレーム <A> を小さい順にソートされた結果でインプレースする	<A> . sort_index ( inplace = True )	sort_index = <A> . sort_index ( )
<A> の <B> を区間を <C> 、ビンのラベルを <D> として分割する	pd . cut ( <A> [ <B> ] , <C> , label = <D> )	<A> = pd . cut ( <B> [ <C> ] , <D> , label = <E> )
<A> を <B> に設定して保存する	<A> . to_csv ( <B> )	plt . to_csv ( <A> , <B> , to_csv = '
データフレーム <A> 全体をコラム <B> と列 <C> が降順になるようにソートし、置き換える	<A> = <A> . sort_values ( [ <B> , <C> ] , ascending = False )	flush = <A> . sort_values ( [ <B> , <C> ] , ascending = False , inplace = True )
六角形のマーカーを用いる	marker = 'h'	markerfacecolor = 'h'
柱状図に <A> データフレームの <B> カラムをする	plt . hist ( <A> [ <B> ] )	range = ( <A> [ <B> ] )
データフレーム <A> 内の <B> を欠損値に変え欠損値が存在する行をドロップされた結果で置き換える	<A> = <A> . replace ( <B> , np . nan ) . dropna ( )	<A> . replace ( <B> , np . nan ) . dropna ( inplace = True )
エクセルファイル <A> を読み込み、表とする	pd . read_excel ( <A> )	start = pd . read_excel ( <A> )
<A> データをタブ区切りで読む	pd . read_csv ( <A> , sep = '\t' )	kind = pd . read_csv ( <A> , sep = '\t' )
ビンを <D> として要素の数が等しくなるように <B> データフレームの <C> コラムを分割し、 <A> に代入する	<A> = pd . qcut ( <B> [ <C> ] , <D> )	marker = pd . qcut ( <B> [ <C> ] , <D> )
<A> 内のカテゴリーを数値データで置き換える	pd . get_dummies ( <A> )	kind = <A> . get_dummies ( <A> )
データフレーム <A> 内に重複があるかどうか検出する	<A> . duplicated ( )	duplicated <A> . duplicated ( )
表データをデータ <B> から読まれた結果を <A> とする	<A> = pd . read_csv ( <B> )	markerfacecolor = pd . read_csv ( <B> )
<A> データフレームの <B> を NaN にした結果を再代入する	<A> = <A> . replace ( <B> , np . nan )	nan <A> = <A> . replace ( <B> , np . nan )
表を <A> からタブ区切りで読み込む	pd . read_csv ( <A> , sep = '\t' )	sep = pd . read_csv ( <A> , sep = '\t' )
<A> の上 5 行	<A> . head ( )	<A> . tail ( )
<A> と <B> の縦棒グラフを真ん中として棒グラフの位置をプロットする	plt . bar ( <A> , <B> , align = 'center' )	<A> . set_index ( <B> , align = 'center' )
<B> から <C> に <A> データフレームの列の名前を変更した結果で置き換える	<A> . rename ( columns = { <B> : <C> } , inplace = True )	<B> <A> . rename ( columns = { <B> : <C> } , inplace = True )
<A> データフレームの中の未記入の値を <B> とし、置き換える	<A> = <A> . fillna ( <B> )	<B> <A> . fillna ( <B> , inplace = True )
カラム <B> と列 <C> を元にデータフレーム <A> 全体を逆順でソートして、置き換える	<A> . sort_values ( [ <B> , <C> ] , ascending = False , inplace = True )	flush = <A> . sort_values ( [ <B> , <C> ] , ascending = False , inplace = True )
<B> 内の欠損を <C> に置き換え、 <A> とする	<A> = <B> . fillna ( <C> )	markeredgecolor = <B> . fillna ( <C> )
<A> の <B> と <C> を降順にソートされた結果を <A> とする	<A> = <A> . sort_values ( [ <B> , <C> ] , ascending = False )	[ <A> = <A> . sort_values ( [ <B> , <C> ] , ascending = False )
<B> の欠損値がある行をドロップし、 <A> にする	<A> = <B> . dropna ( )	dropna <A> = <B> . dropna ( )
データフレーム <B> の <C> を未入力の値とした結果を <A> にする	<A> = <B> . replace ( <C> , np . nan )	<B> <A> = <B> . replace ( <C> , np . nan )
<A> の <B> を削除し、置き換える	<A> = <A> . drop ( <B> , axis = 1 )	<A> . drop ( <B> , axis = 1 , inplace = True )
<B> という名前のエクセルファイルを表として読んだ結果を <A> に代入する	<A> = pd . read_excel ( <B> )	markerfacecolor = pd . read_excel ( <A> , <B> )
データフレーム <B> の中のコラム <C> のダブる行を落とし、 <A> にする	<A> = <B> . drop_duplicates ( subset = <C> )	markeredgecolor = <B> . drop_duplicates ( subset = <C> )
<A> データフレームの <B> 行目を取り除く	<A> . drop ( <B> )	<A> = <B> . drop ( <C> )
データフレーム <A> 中の未記入の値を含む行を落とし、置き換える	<A> = <A> . dropna ( )	dropna = <A> . dropna ( )
カンマ区切りで <B> を読んだ結果を <A> とする	<A> = pd . read_csv ( <B> , sep = ',' )	markerfacecolor = pd . read_csv ( <A> , sep = ',' )
エクセルファイル <B> を読み込んでデータフレームに格納し、 <A> とする	<A> = pd . read_excel ( <B> )	markerfacecolor = pd . read_excel ( <A> , <B> )
<B> の <C> を四分位数ごとで分割された結果を <A> とする	<A> = pd . qcut ( <B> [ <C> ] , 4 )	<A> = <A> . qcut ( <B> [ <C> ] , 4 )
色を紺色とする	color = 'navy'	flush = 'navy'
ある行を <A> データフレーム中の NaN が消す	<A> . dropna ( )	plt . dropna ( )
<A> データフレーム中の重複要素がある行を落とした結果で置き換える	<A> = <A> . drop_duplicates ( )	kind = <A> . drop_duplicates ( )
<A> データフレーム全体をインデックスを軸に小さい順でソートして、 <A> に代入する	<A> = <A> . sort_index ( )	sort_index = <A> . sort_index ( )
ある <B> を <A> 中に NaN で埋めて、置き換える	<A> . replace ( <B> , np . nan , inplace = True )	np . replace ( <A> , <B> , np . nan , inplace = True )
<A> 全体を <B> と <C> に基づいて降順でソートし、置き換える	<A> = <A> . sort_values ( [ <B> , <C> ] , ascending = False )	flush = <A> . sort_values ( [ <B> , <C> ] , ascending = False , inplace = True )
<B> の欠損値を <C> にし、 <A> とする	<A> = <B> . fillna ( <C> )	markeredgecolor = <B> . fillna ( <C> )
<C> で昇順に <B> 全体をソートされた結果を <A> とする	<A> = <B> . sort_values ( <C> )	markerfacecolor = <B> . sort_values ( <C> )
エクセルファイル <B> の全てのシートを読み込み、表データとした結果を <A> にする	<A> = pd . read_excel ( <B> , sheet_name = None )	markerfacecolor = pd . read_excel ( <B> , sheet_name = None )
最大列数を <A> 列に設定する	pd . set_option ( 'display.max_columns' , <A> )	'display.max_columns' = pd . set_option ( 'display.max_columns' , <A> )
一番左の列をインデックスにセットして、データ <B> を読んだ結果を <A> とする	<A> = pd . read_csv ( <B> , index_col = 0 )	0 = pd . read_csv ( <A> , index_col = 0 )
<A> 内のそれぞれのカラムにある <B> の個数の合計値	<A> . isin ( [ <B> ] ) . sum ( )	isin <A> = <B> . isin ( [ <C> ] ) . sum ( )
<A> の <B> を落とし、置き換える	<A> . drop ( <B> , axis = 1 , inplace = True )	marker = <A> . drop ( <B> , axis = 1 )
<A> の <B> を未入力の値で埋め、再代入する	<A> = <A> . replace ( <B> , np . nan )	plt . replace ( <A> , <B> , np . nan , inplace = True )
マーカーの色は紫色を用いる	markerfacecolor = 'purple'	marker = 'purple'
<B> をインデックスを元に小さい順にソートして、 <A> とする	<A> = <B> . sort_index ( )	markerfacecolor = <B> . sort_index ( )
エンコーディングを shift - jis で、データ <A> を読み込む	pd . read_csv ( <A> , encoding = 'shift_jis' )	encoding = pd . read_csv ( <A> , encoding = 'shift_jis' )
<B> 中にある <C> を NaN で埋め、 <A> とする	<A> = <B> . replace ( <C> , np . nan )	<B> <A> = <B> . replace ( <C> , np . nan )
<A> の <B> ごとの <C> の数を算出する	<A> . groupby ( [ <B> ] ) [ <C> ] . count ( )	} = <A> . groupby ( [ <B> ] ) [ <C> ] . count ( )
ある行をデータフレーム <A> 内の NaN が削除する	<A> . dropna ( )	plt . dropna ( )
<A> を昇順に <B> でソートした結果を <A> に代入する	<A> = <A> . sort_values ( <B> )	range = <A> . sort_values ( <B> )
ダブっている最後の行を残して <B> の中の重複している行を取り除かれた結果を <A> にする	<A> = <B> . drop_duplicates ( keep = False )	markeredgecolor = <B> . drop_duplicates ( keep = False )
ある <B> を <A> データフレーム中に NaN に置き換えた結果を再代入する	<A> = <A> . replace ( <B> , np . nan )	nan <A> = <A> . replace ( <B> , np . nan )
グリッドをグラフに付ける	plt . grid ( True )	grid = plt . grid ( True )
<A> データフレームの中の未記入の値を落とす	<A> . dropna ( )	plt . dropna ( )
データフレーム <B> 全体をコラム <C> を元に昇順でソートして、 <A> にする	<A> = <B> . sort_values ( <C> )	markerfacecolor = <B> . sort_values ( <C> )
<B> データフレームの <C> を NaN にされた結果を <A> とする	<A> = <B> . replace ( <C> , np . nan )	<B> <A> = <B> . replace ( <C> , np . nan )
<B> の <C> をビンを <D> 、ビンのラベルを 0 始まりの連番として分割して、 <A> とする	<A> = pd . cut ( <B> [ <C> ] , <D> , label = False )	[ <A> = pd . cut ( <B> [ <C> ] , <D> , label = False )
マーカーの形状の色は黄緑色を用いる	markerfacecolor = 'greenyellow'	markeredgecolor = 'greenyellow'
ある行を <A> の中の NaN が取り除いた結果を <A> とする	<A> = <A> . dropna ( )	errors = <A> . dropna ( )
<B> の <C> を NaN で補われた、結果を <A> とする	<A> = <B> . replace ( <C> , np . nan )	<B> <A> = <B> . replace ( <C> , np . nan )
ある <B> を <A> データフレーム中に NaN で埋め、置き換える	<A> . replace ( <B> , np . nan , inplace = True )	np . replace ( <A> , <B> , np . nan , inplace = True )
<A> データフレームの中の未入力の値を <B> に置換し、再代入する	<A> = <A> . fillna ( <B> )	plt . fillna ( <A> , <B> , inplace = True )
<A> データフレーム内の重複した行をドロップした結果でインプレースする	<A> . drop_duplicates ( inplace = True )	inplace <A> . drop_duplicates ( inplace = True )
<A> 内の <B> の重複している行を削除する	<A> . drop_duplicates ( subset = <B> )	<A> = <B> . drop_duplicates ( subset = <C> )
データフレーム <A> のインデックスを振り直した結果でインプレースする	<A> . reset_index ( inplace = True )	inplace <A> . reset_index ( inplace = True )
<A> 内の欠損を <A> の平均値で埋めて、置き換える	<A> . fillna ( <A> . mean ( ) , inplace = True )	kind = <A> . fillna ( <A> . mean ( ) )
<A> 内のそれぞれのカラムにある <B> の個数	<A> . isin ( [ <B> ] ) . sum ( )	isin <A> = <B> . isin ( [ <C> ] ) . sum ( )
<A> データフレームの <B> コラムの名前を <C> に <D> 列の名前を <E> にリネームした結果で置き換える	<A> . rename ( columns = { <B> : <C> , <D> : <E> } , inplace = True )	<B> <A> . rename ( columns = { <B> : <C> , <D> : <E> } , inplace = True )
データフレーム <A> 中の重複している行を削除する	<A> . drop_duplicates ( )	pd . drop_duplicates ( <A> )
エクセルファイル <B> の <C> を読み込み、表とされた結果を <A> に代入する	<A> = pd . read_excel ( <B> , sheet_name = <C> )	marker = pd . read_excel ( <B> , sheet_name = <C> )
ある <B> を <A> の中に未入力の値で埋め、 <A> に代入する	<A> = <A> . replace ( <B> , np . nan )	nan <A> = <A> . replace ( <B> , np . nan )
<B> から <C> の区間のヒストグラムを用いて <A> をプロットする	plt . hist ( <A> , range = ( <B> , <C> ) )	<A> = <B> . rename ( columns = { <C> : <D> } )
データフレーム <A> をカラム <B> と列 <C> に基づいて降順でソートした結果で置き換える	<A> = <A> . sort_values ( [ <B> , <C> ] , ascending = False )	flush = <A> . sort_values ( [ <B> , <C> ] , ascending = False , inplace = True )
<B> というファイル名でエクセルに <A> を表示する	<A> . to_excel ( <B> )	markerfacecolor = <A> . to_excel ( <B> )
データフレーム <A> に重複があるのかどうか	<A> . duplicated ( )	duplicated <A> . duplicated ( )
エクセルファイル <A> の <B> を表データにする	pd . read_excel ( <A> , sheet_name = <B> )	<A> . pd . read_excel ( <B> , sheet_name = <B> )
<B> という名前のエクセルファイルの <C> 番目のシートをデータフレームとして読み込んだ結果を <A> とする	<A> = pd . read_excel ( <B> , sheet_name = <C> )	marker = pd . read_excel ( <B> , sheet_name = <C> )
<A> データフレーム内の重複要素がある行をドロップし、再代入する	<A> = <A> . drop_duplicates ( )	xticks <A> = <A> . drop_duplicates ( )
エクセルデータ <B> を表に読み、 <A> に代入する	<A> = pd . read_excel ( <B> )	marker = pd . read_excel ( <A> , <B> )
エクセルファイル <A> の <B> を読み込む	pd . read_excel ( <A> , sheet_name = <B> )	sheet_name = pd . read_excel ( <A> , sheet_name = <B> )
<A> をインデックスで小さい順に並び替えた結果でインプレースする	<A> . sort_index ( inplace = True )	sort_index = <A> . sort_index ( )
色を紫とする	color = 'purple'	markeredgecolor = 'purple'
<B> の横棒グラフを軸を <A> としてプロットする	plt . barh ( <A> , <B> , align = 'center' )	<A> = plt . barh ( <B> , align = 'center' )
<A> データフレームをインデックスどおりに昇順でソートした結果を <A> に代入する	<A> = <A> . sort_index ( )	sort_index = <A> . sort_index ( )
区関数を <D> として <B> データフレームの <C> コラムを分割した結果を <A> に代入する	<A> = pd . cut ( <B> [ <C> ] , <D> )	[ <A> = pd . cut ( <B> [ <C> ] , <D> )
<A> 内に重複があるのかどうか検出	<A> . duplicated ( )	duplicated <A> . duplicated ( )
★の打点を使う	marker = '*'	markerfacecolor = '*'
<A> にグラフの x 軸のラベルを変更する	plt . xlabel ( <A> )	pd . xlabel ( <A> )
データフレーム <A> の列 <B> 、コラム <C> 、カラム <D> 、列 <E> を選ぶ	<A> [ [ <B> , <C> , <D> , <E> ] ]	sns . pairplot ( <A> [ [ <B> , <C> , <D> , <E> ] ] )
インデックスを元に <A> データフレーム全体を小さい順でソートし、置き換える	<A> . sort_index ( inplace = True )	kind = <A> . sort_index ( )
要素の数が等しくなるように <B> データフレームの <C> コラムをビンの数を <D> として分割して、 <A> とする	<A> = pd . qcut ( <B> [ <C> ] , <D> )	marker = pd . qcut ( <B> [ <C> ] , <D> )
<A> データフレーム中の重複要素がある行を消した結果を再代入する	<A> = <A> . drop_duplicates ( )	xticks <A> = <A> . drop_duplicates ( )
CSV ファイル <A> をデータフレームとしてタブ区切りで読み込む	pd . read_csv ( <A> , sep = '\t' )	sep = pd . read_csv ( <A> , sep = '\t' )
<A> 中の <B> に重複がある行を消した結果を <A> に代入する	<A> = <A> . drop_duplicates ( subset = <B> )	markerfacecolor = <A> . drop_duplicates ( subset = <B> )
データフレーム <A> の中のコラム <B> に重複はあるのかどうか確認を調べる	<A> . duplicated ( subset = <B> )	sns . duplicated ( subset = <B> )
<A> データフレームの中の未記入の値が存在する行を落とす	<A> . dropna ( )	plt . dropna ( )
<A> データフレーム内の未記入の値がある行を削除して、置き換える	<A> = <A> . dropna ( )	dropna = <A> . dropna ( )
データフレーム <A> の未入力の値がある行を取り除いた結果を <A> にする	<A> = <A> . dropna ( )	xticks <A> = <A> . dropna ( )
<A> の <B> をインデックスとしてセットして、 <A> に代入する	<A> = <A> . set_index ( <B> )	plt . set_index ( <A> , <B> , align = True )
データフレーム <B> の欠損値を <C> に変え、 <A> とする	<A> = <B> . fillna ( <C> )	markeredgecolor = <B> . fillna ( <C> )
<A> データフレームの <B> コラムをインデックスに指定して、再代入する	<A> = <A> . set_index ( <B> )	plt . set_index ( <A> , <B> , inplace = True )
エクセルファイル <B> の全てのシートを読み込み、表データに格納して、 <A> とする	<A> = pd . read_excel ( <B> , sheet_name = None )	markerfacecolor = pd . read_excel ( <B> , sheet_name = None )
存在する <B> を <A> データフレーム内に欠損値とした結果を再代入する	<A> = <A> . replace ( <B> , np . nan )	nan <A> = <A> . replace ( <B> , np . nan )
<A> と <B> のグラフを <C> とラベル付けして描写する	plt . plot ( <A> , <B> , label = <C> )	pd . cut ( <A> [ <B> , <C> ] , label = False )
<C> から <D> にデータフレーム <B> の列名を変え、 <A> とする	<A> = <B> . rename ( columns = { <C> : <D> } )	} = <B> . rename ( columns = { <C> : <D> } )
<A> データフレーム全体を <B> カラムと <C> 列を軸に降順でソートした結果で置き換える	<A> = <A> . sort_values ( [ <B> , <C> ] , ascending = False )	flush = <A> . sort_values ( [ <B> , <C> ] , ascending = False , inplace = True )
<A> データフレームを <B> ファイルに書き込む	<A> . to_csv ( <B> )	to_csv <A> . to_csv ( <B> )
データフレーム <A> の中のインデックスが <B> の行	<A> . loc [ <B> ]	<A> . set_index ( <B> )
<A> の <B> と <C> と <D> についての箱ひげ図を表示する	plt . boxplot ( [ <A> [ <B> ] , <A> [ <C> ] , <A> [ <D> ] ] )	<A> . plt . boxplot ( [ <B> ] , <A> [ <C> ] , <A> [ <D> ] ] )
<A> をエクセルファイル <B> という名前で表示する	<A> . to_excel ( <B> )	to_excel . to_excel ( <A> , <B> )
エクセルファイル <A> の <B> 番目のシートを表とする	pd . read_excel ( <A> , sheet_name = <B> )	, pd . read_excel ( <A> , sheet_name = <B> , sheet_name = <B> )
y 軸の軸の名前を <A> に指定する	plt . ylabel ( <A> )	color = <A> . ylabel ( <A> )
データフレーム <A> のカラム <B> の月	<A> [ <B> ] . dt . month	month [ <A> [ <B> ] . dt . month
バッファリングの大きさは <A> にする	buffering = <A>	file = <A>
データフレーム <A> のコラム <B> を取り除いて、インプレースする	<A> . drop ( <B> , axis = 1 , inplace = True )	pd . merge ( <A> , <B> , axis = 1 , inplace = True )
ビン数を <C> 、ビンのラベルをインデックスとして <A> の <B> を分割する	pd . cut ( <A> [ <B> ] , <C> , label = False )	<A> . pd . cut ( <B> [ <C> ] , <D> , label = False )
データフレーム <A> の中の未記入の値を <B> で置き換える	<A> . fillna ( <B> )	fillna <A> . fillna ( <B> )
<A> を <B> という名前にして保存する	<A> . to_csv ( <B> )	to_csv <A> . to_csv ( <B> )
エクセルファイル <A> のシート名 <B> をデータフレームに格納する	pd . read_excel ( <A> , sheet_name = <B> )	sheet_name = pd . read_excel ( <A> , sheet_name = <B> )
エンコーディングを shift - jis として、 <A> データを読む	pd . read_csv ( <A> , encoding = 'shift_jis' )	encoding = pd . read_csv ( <A> , encoding = 'shift_jis' )
<A> データフレーム中の NaN を消して、置き換える	<A> = <A> . dropna ( )	kind = <A> . dropna ( )
存在する <B> を <A> データフレーム内に欠損値で補われた、結果で書き換える	<A> . replace ( <B> , np . nan , inplace = True )	replace <A> . replace ( <B> , np . nan , inplace = True )
グラフの色を赤色とする	color = 'red'	markeredgecolor = 'red'
<B> から <C> に <A> のカラム名をリネームする	<A> . rename ( columns = { <B> : <C> } )	} . rename ( columns = { <B> : <C> } )
<A> の <B> を欠損値に置換した結果を <A> に代入する	<A> = <A> . replace ( <B> , np . nan )	nan <A> = <A> . replace ( <B> , np . nan )
表に <B> データを格納した結果を <A> に代入する	<A> = pd . read_csv ( <B> )	markerfacecolor = pd . read_csv ( <B> )
<A> の列名を <B> から <C> に <D> から <E> にリネームされた結果で置き換える	<A> = <A> . rename ( columns = { <B> : <C> , <D> : <E> } )	<B> <A> . rename ( columns = { <B> : <C> , <D> : <E> } , inplace = True )
<B> という名前のエクセルファイルの <C> シート名を表として読み込んだ結果を <A> に代入する	<A> = pd . read_excel ( <B> , sheet_name = <C> )	markerfacecolor = pd . read_excel ( <B> , sheet_name = <C> )
ある行をデータフレーム <A> の中の未入力の値が落とされた結果で置き換える	<A> = <A> . dropna ( )	dropna = <A> . dropna ( )
昇順に <B> で <A> をソートした結果を <A> にする	<A> = <A> . sort_values ( <B> )	plt . sort_values <A> <B> , inplace = True )
<B> の <C> を要素数が等しくなるように区間を <D> として分割した結果を <A> にする	<A> = pd . qcut ( <B> [ <C> ] , <D> )	marker = pd . qcut ( <B> [ <C> ] , <D> )
データフレーム <A> 中のコラム <B> の重複している行を削除する	<A> . drop_duplicates ( subset = <B> )	<A> = <B> . drop_duplicates ( subset = <C> )
インデックスを元に <A> データフレームを小さい順にソートした結果で置き換える	<A> = <A> . sort_index ( )	kind = <A> . sort_index ( )
<A> をインデックスを元に小さい順でソートした結果を <A> にする	<A> = <A> . sort_index ( )	sort_index = <A> . sort_index ( )
<B> から <C> に <A> の列名を変える	<A> . rename ( columns = { <B> : <C> } )	<B> <A> . rename ( columns = { <B> : <C> } )
y 軸を <A> として <B> の横向き棒グラフを表示する	plt . barh ( <A> , <B> )	pd . barh ( <A> , <B> , align = 'center' )
データフレーム <A> の中の未記入の値がある行を取り除く	<A> . dropna ( )	errors . dropna ( )
グラフ線のスタイルは破線と点線を使う	linestyle = 'dashbot'	markeredgecolor = 'dashbot'
打点の色を紫とする	markerfacecolor = 'purple'	marker = 'purple'
マーカーのエッジの大きさは <A> を用いる	markeredgewidth = <A>	range = ( <A> , <B> )
<B> 中にある <C> を未記入の値とされた結果を <A> にする	<A> = <B> . replace ( <C> , np . nan )	<B> <A> = <B> . replace ( <C> , np . nan )
<A> 内の欠損値を含む行をドロップする	<A> . dropna ( )	plt . dropna ( )
データフレーム <A> に TF で重複があるのかどうかを返す	<A> . duplicated ( )	duplicated <A> . duplicated ( )
<B> データフレームの <C> カラムをインデックス、 <D> カラムをコラムとしたピボットテーブルを作成された結果を <A> にする	<A> = <B> . pivot_table ( index = <C> , columns = <D> )	markerfacecolor = <B> . pivot_table ( index = <C> , columns = <D> )
<A> を出力先として適用する	file = <A>	plt . savefig ( <A> )
インデックスを軸に <B> 全体を小さい順にソートし、 <A> にする	<A> = <B> . sort_index ( )	markerfacecolor = <B> . sort_index ( )
中心に設定して、グラフの <A> 軸を <A> とした <B> の鉛直棒グラフを棒グラフの位置を描写する	plt . bar ( <A> , <B> , align = 'center' )	pd . bar ( <A> , <B> , align = 'center' )
<A> を <B> という CSV ファイルとして保存する	<A> . to_csv ( <B> )	plt . to_csv ( <A> , <B> , to_csv = 'center' )
<A> データフレームの <B> カラムをグループ化したときの値ごとのデータの数	<A> . groupby ( <B> ) . size ( )	<B> <A> [ <B> ] . size ( )
<B> の <C> を中央値で分割した結果を <A> にする	<A> = pd . qcut ( <B> [ <C> ] , 2 )	[ <A> = pd . qcut ( <B> [ <C> ] , 2 )
エクセルファイル <B> の <C> 番目のシートを表として読み込み、 <A> に代入する	<A> = pd . read_excel ( <B> , sheet_name = <C> )	markerfacecolor = pd . read_excel ( <B> , sheet_name = <C> )
<A> の <B> を欠損値にした結果でインプレースする	<A> . replace ( <B> , np . nan , inplace = True )	replace <A> . replace ( <B> , np . nan , inplace = True )
データフレーム <A> 内の重複している行を削除した結果を <A> に代入する	<A> = <A> . drop_duplicates ( )	<A> = pd . drop_duplicates ( )
<A> 全体をインデックスで昇順にソートし、置き換える	<A> = <A> . sort_index ( )	kind = <A> . sort_index ( )
データフレーム <A> の数値データ以外の統計情報	<A> . describe ( include = 'O' )	'O' = <A> . describe ( include = 'O' )
<A> の <C> に <B> の名前を <E> に <D> の名前をリネームした結果を <A> にする	<A> = <A> . rename ( columns = { <B> : <C> , <D> : <E> } )	<B> <A> . rename ( columns = { <B> : <C> , <D> : <E> } , inplace = True )
<B> データフレームと <C> データフレームを縦向きにマージされた結果を <A> にする	<A> = pd . concat ( [ <B> , <C> ] )	markerfacecolor = pd . concat ( [ <A> , <B> , <C> ] )
<A> 番目までのコラムを表示させる	pd . set_option ( 'display.max_columns' , <A> )	<A> = pd . set_option ( 'display.max_rows' , <A> )
凡例をグラフに被らない位置に付ける	plt . legend ( loc = 'best' )	<A> = plt . legend ( loc = 'best' )
<A> データフレーム全体をインデックスを軸に小さい順にソートし、置き換える	<A> . sort_index ( inplace = True )	kind = <A> . sort_index ( )
エクセルファイル <A> を読み込む	pd . read_excel ( <A> )	head = pd . read_excel ( <A> )
<A> データフレームの <B> を NaN とした結果でインプレースする	<A> . replace ( <B> , np . nan , inplace = True )	replace <A> . replace ( <B> , np . nan , inplace = True )
<A> 中の <B> を NaN に変え NaN が存在する行を消す	<A> . replace ( <B> , np . nan ) . dropna ( )	replace <A> . replace ( <B> , np . nan ) . dropna ( )
ピボット操作でデータフレーム <A> の列を行に変更する	<A> . stack ( )	alpha = <A> . stack ( )
データフレーム <B> 内の欠損値を含む行をドロップされた結果を <A> とする	<A> = <B> . dropna ( )	dropna <A> = <B> . dropna ( )
<B> データフレーム全体をインデックスで順にソートされた結果を <A> とする	<A> = <B> . sort_index ( )	markerfacecolor = <B> . sort_index ( )
データフレーム <A> とデータフレーム <B> を縦方向にマージ	pd . concat ( [ <A> , <B> ] )	start = pd . concat ( [ <A> , <B> ] )
データ <B> を表に格納した結果を <A> にする	<A> = pd . read_csv ( <B> )	markerfacecolor = pd . read_csv ( <A> , <B> )
データフレーム <A> 内の未入力の値がある行を削除した結果を <A> とする	<A> = <A> . dropna ( )	errors = <A> . dropna ( )
小数点以下 <A> 桁まで表示するように変更する	pd . set_option ( 'precision' , <A> )	'precision' = <A> . set_option ( 'precision' , <A> )
<B> データフレームの中にある <C> を未記入の値に置き換えた結果を <A> に代入する	<A> = <B> . replace ( <C> , np . nan )	<B> <A> = <B> . replace ( <C> , np . nan )
<A> データフレームの中の列にある <B> の数	<A> . isin ( [ <B> ] ) . sum ( )	isin <A> . isin ( [ <B> ] ) . sum ( )
昇順に <B> 全体を <C> でソートして、 <A> に代入する	<A> = <B> . sort_values ( <C> )	markerfacecolor = <B> . sort_values ( <C> )
データフレーム <A> の中の未記入の値を <B> に置き換えて、置き換える	<A> = <A> . fillna ( <B> )	flush = <A> . fillna ( <B> )
<B> から <C> に <A> データフレームのカラム名をして、置き換える	<A> = <A> . rename ( columns = { <B> : <C> } )	<B> <A> . rename ( columns = { <B> : <C> } , inplace = True )
エクセルファイル <A> を読み込み、表データにする	pd . read_excel ( <A> )	start = pd . read_excel ( <A> )
エクセルファイル <B> のシート名 <C> を読み込み、表データにして、 <A> にする	<A> = pd . read_excel ( <B> , sheet_name = <C> )	markerfacecolor = pd . read_excel ( <B> , sheet_name = <C> )
データフレーム <A> をインデックスで昇順にソートした結果を <A> にする	<A> = <A> . sort_index ( )	sort_index = <A> . sort_index ( )
エクセルファイル <B> の全てのシートを読み込み、表に格納し、 <A> に代入する	<A> = pd . read_excel ( <B> , sheet_name = None )	markerfacecolor = pd . read_excel ( <B> , sheet_name = None )
エクセルファイル <B> に <A> を加える	<A> . to_excel ( <B> )	to_excel . to_excel ( <A> , <B> )
<A> 内に存在する <B> を欠損で置換された結果を再代入する	<A> = <A> . replace ( <B> , np . nan )	nan <A> = <A> . replace ( <B> , np . nan )
マーカーの種類を○とする	marker = 'o'	markerfacecolor = 'o'
データフレーム <A> のコラム <B> についての標準偏差	<A> [ <B> ] . std ( )	<A> [ [ <B> ] . std ( )
<A> 番まで列が表示するように変更する	pd . set_option ( 'display.max_columns' , <A> )	'display.max_columns' = pd . set_option ( 'display.max_columns' , <A> )
データフレーム <A> をカラム <B> と列 <C> で降順にソートした結果を <A> とする	<A> = <A> . sort_values ( [ <B> , <C> ] , ascending = False )	[ <A> = <A> . sort_values ( [ <B> , <C> ] , ascending = False )
エクセルファイル <A> の <B> 番目のシートを表にする	pd . read_excel ( <A> , sheet_name = <B> )	<A> . pd . read_excel ( <B> , sheet_name = <B> )
<A> 内の <B> と <C> に重複があるのかどうか	<A> . duplicated ( subset = [ <B> , <C> ] )	<B> <A> . duplicated ( subset = [ <C> ] )
<B> から <C> に <A> の列の名前を変える	<A> . rename ( columns = { <B> : <C> } )	} = <B> . rename ( columns = { <C> : <D> } )
重複する最後の行を残してデータフレーム <B> 中の重複している行を消し、 <A> とする	<A> = <B> . drop_duplicates ( keep = False )	markeredgecolor = <B> . drop_duplicates ( keep = False )
<A> の <B> をビンを <C> 、ビンのラベルを 0 始まりの連番として分割する	pd . cut ( <A> [ <B> ] , <C> , label = False )	False = pd . cut ( <A> [ <B> ] , <C> , label = False )
<B> と <C> が逆順になるように <A> をソートし、 <A> にする	<A> = <A> . sort_values ( [ <B> , <C> ] , ascending = False )	[ <A> = <A> . sort_values ( [ <B> , <C> ] , ascending = False )
<A> の <B> を NaN で補った結果を再代入する	<A> = <A> . replace ( <B> , np . nan )	nan <A> = <A> . replace ( <B> , np . nan )
マーカーを四角とする	marker = 's'	sheet_name = 's'
<A> データフレームの <B> コラムをビンの数を <C> 、ビンのラベルを 0 始まりの連番として分割する	pd . cut ( <A> [ <B> ] , <C> , label = False )	False = pd . cut ( <A> [ <B> ] , <C> , label = False )
ヘッダーを設定せずにデータ <A> を読み込む	pd . read_csv ( <A> , header = None )	None = pd . read_csv ( <A> , header = None )
先頭の列をインデックスと設定して、 <A> を表として読む	pd . read_csv ( <A> , index_col = 0 )	start = pd . read_csv ( <A> , index_col = 0 )
エクセルファイル <A> の <B> を読み込み、表データに格納する	pd . read_excel ( <A> , sheet_name = <B> )	<A> = pd . read_excel ( <B> , sheet_name = <C> )
データフレーム <A> のコラム <B> をドロップする	<A> . drop ( <B> , axis = 1 )	plt . drop ( <A> , <B> , axis = 1 )
<A> 全体をインデックスで順番になるようにソートする	<A> . sort_index ( )	pd . sort_index ( )
表に <B> を格納した結果を <A> とする	<A> = pd . read_csv ( <B> )	markerfacecolor = pd . read_csv ( <B> )
<A> 全体をインデックスで順番になるようにソートした結果で置き換える	<A> . sort_index ( inplace = True )	kind = <A> . sort_index ( )
<A> のインデックスをリセットセットして、元のインデックスを削除する	<A> . reset_index ( drop = True )	<B> <A> . reset_index ( drop = True )
<A> をタブ区切りで読み込む	pd . read_csv ( <A> , sep = '\t' )	kind = pd . read_csv ( <A> , sep = '\t' )
CSV ファイル <B> をデータフレームとして読み込み、 <A> にする	<A> = pd . read_csv ( <B> )	markerfacecolor = pd . read_csv ( <B> )
エクセルファイル <A> の <B> 番目のシートを読み込み、表にする	pd . read_excel ( <A> , sheet_name = <B> )	<A> = pd . read_excel ( <B> , sheet_name = <C> )
エクセルファイル <B> の <C> 番目のシートを表として読み、 <A> にする	<A> = pd . read_excel ( <B> , sheet_name = <C> )	markerfacecolor = pd . read_excel ( <B> , sheet_name = <C> )
<B> データフレーム中にある <C> を NaN で置き換えて、 <A> とする	<A> = <B> . replace ( <C> , np . nan )	<B> <A> = <B> . replace ( <C> , np . nan )
<A> データフレームの <B> を欠損に置換し、 <A> に代入する	<A> = <A> . replace ( <B> , np . nan )	nan <A> = <A> . replace ( <B> , np . nan )
<A> データフレームの <B> を未記入の値で埋めた結果を再代入する	<A> = <A> . replace ( <B> , np . nan )	nan <A> = <A> . replace ( <B> , np . nan )
<B> から <C> にデータフレーム <A> のカラム名を変更する	<A> . rename ( columns = { <B> : <C> } )	plt . hist ( <A> [ <B> ] )
データフレーム <A> の <B> を NaN に置換し、書き換える	<A> . replace ( <B> , np . nan , inplace = True )	replace <A> . replace ( <B> , np . nan , inplace = True )
<B> と <C> が逆順になるように <A> 全体をソートした結果を再代入する	<A> = <A> . sort_values ( [ <B> , <C> ] , ascending = False )	[ <A> = <A> . sort_values ( [ <B> , <C> ] , ascending = False )
<A> データフレームのもともとあったインデックスをリセットして、再代入する	<A> = <A> . reset_index ( drop = True )	True = <A> . reset_index ( drop = True )
ある行を <A> データフレーム中の NaN が落として、 <A> に代入する	<A> = <A> . dropna ( )	errors = <A> . dropna ( )
グラフ内に凡例を入れる	plt . legend ( )	<A> . isnull ( ) . sum ( )
エクセルファイル <B> を読み込み、表データとされた結果を <A> に代入する	<A> = pd . read_excel ( <B> )	markerfacecolor = pd . read_excel ( <A> , <B> )
<A> 内の重複した行の数	<A> . duplicated ( ) . sum ( )	<B> <A> = <A> . duplicated ( ) . sum ( )
カラム <B> と列 <C> を元にデータフレーム <A> を逆順でソートする	<A> . sort_values ( [ <B> , <C> ] , ascending = False )	sort_values <A> . sort_values ( [ <B> , <C> ] , ascending = False )
設定して横向きの棒グラフを棒の位置を中心に表示する	plt . barh ( y , x , align = 'center' )	plt . barh ( y , x , x , align = 'center' )
箱ひげ図に <A> と <B> と <C> を表示する	plt . boxplot ( [ <A> , <B> , <C> ] )	<A> = plt . boxplot ( [ <B> , <C> ] )
<A> 行目までを見れるように設定する	pd . set_option ( 'display.max_rows' , <A> )	start = pd . set_option ( 'display.max_rows' , <A> )
<A> をインデックスで並び替えて、置き換える	<A> = <A> . sort_index ( )	kind = <A> . sort_index ( )
<A> を <B> を軸に昇順でソートして、 <A> にする	<A> = <A> . sort_values ( <B> )	range = <A> . sort_values ( <B> )
<B> という名前のエクセルファイルの全てのシートを表データとして読み込まれた結果を <A> にする	<A> = pd . read_excel ( <B> , sheet_name = None )	markerfacecolor = pd . read_excel ( <A> , sheet_name = None )
<B> 内の欠損値を <C> で置き換えて、 <A> にする	<A> = <B> . fillna ( <C> )	markeredgecolor = <B> . fillna ( <C> )
データフレーム <A> 中のそれぞれのコラムに存在する <B> の数の合計	<A> . isin ( [ <B> ] ) . sum ( )	isin <A> = <B> . isin ( [ <C> ] ) . sum ( )
縦軸を <A> として <B> の横向き棒グラフをプロットする	plt . barh ( <A> , <B> )	barh plt . barh ( <A> , <B> , align = 'center' )
<B> の数値以外のデータを数値で扱えるように処理して、 <A> とする	<A> = pd . get_dummies ( <B> )	markerfacecolor = pd . get_dummies ( <A> , <B> )
<A> データフレーム中の NaN を含む行を消した結果で置き換える	<A> = <A> . dropna ( )	dropna = <A> . dropna ( )
データフレーム <A> 中に存在する <B> を NaN で補われた、結果を再代入する	<A> = <A> . replace ( <B> , np . nan )	nan <A> = <A> . replace ( <B> , np . nan )
<A> 中の NaN がある行を削除した結果で置き換える	<A> . dropna ( inplace = True )	dropna = <A> . dropna ( )
データフレーム <A> の中の列 <B> と列 <C> に重複はあるのかどうか検出	<A> . duplicated ( subset = [ <B> , <C> ] )	<B> <A> . duplicated ( subset = [ <C> ] )
データフレーム <A> の <B> 行目までを確認する	<A> [ : <B> ]	[ <A> [ <B> ] . drop ( <C> ] )
<A> の <B> 行目以降	<A> [ <B> : ]	[ <A> [ <B> : ]
エクセルファイル <B> の <C> からデータフレームを読まれた結果を <A> にする	<A> = pd . read_excel ( <B> , sheet_name = <C> )	markerfacecolor = pd . read_excel ( <B> , sheet_name = <C> )
データフレーム <A> のコラム <B> をインデックスとして設定して、置き換える	<A> . set_index ( <B> , inplace = True )	<A> = <A> . set_index ( <B> )
データフレーム <A> の列名を <D> から <E> に <B> から <C> にリネームする	<A> . rename ( columns = { <B> : <C> , <D> : <E> } )	<B> <A> . rename ( columns = { <C> : <D> , <E> : <F> } )
データフレーム <A> 内の重複要素がある行を削除した結果でインプレースする	<A> . drop_duplicates ( inplace = True )	inplace <A> . drop_duplicates ( inplace = True )
年月日のデータにデータフレーム <A> のカラム <B> を変換する	pd . to_datetime ( <A> [ <B> ] )	range = ( <A> [ <B> ] )
存在する <B> を <A> データフレーム内に欠損にし、置き換える	<A> = <A> . replace ( <B> , np . nan )	np . replace ( <A> , <B> , np . nan , inplace = True )
グラフに格子を入れる	plt . grid ( True )	grid = plt . grid ( True )
<A> 中の欠損を <B> で埋めた結果で置き換える	<A> = <A> . fillna ( <B> )	<B> <A> . fillna ( <B> , inplace = True )
データフレーム <A> の中の重複要素がある行を取り除き、置き換える	<A> = <A> . drop_duplicates ( )	kind = <A> . drop_duplicates ( )
データフレーム <A> をコラム <B> と列 <C> が値の大きい順になるようにソートした結果を <A> とする	<A> = <A> . sort_values ( [ <B> , <C> ] , ascending = False )	[ <A> = <A> . sort_values ( [ <B> , <C> ] , ascending = False )
<B> データフレームの中のカテゴリ変数をダミー変数にし、 <A> にする	<A> = pd . get_dummies ( <B> )	markerfacecolor = pd . get_dummies ( <A> , <B> )
<A> データフレームの中の未入力の値を <A> データフレームの平均で補って、置き換える	<A> . fillna ( <A> . mean ( ) , inplace = True )	pd . fillna ( <A> . mean ( ) , inplace = True )
<A> の <B> 行目をドロップし、置き換える	<A> = <A> . drop ( <B> )	marker = <A> . drop ( <B> )
<A> 内の NaN がある行をドロップし、 <A> とする	<A> = <A> . dropna ( )	xticks <A> = <A> . dropna ( )
データフレーム <A> のインデックス名を <B> から <C> にリネームする	<A> . rename ( index = { <B> : <C> } )	<B> <A> . rename ( index = { <C> : <D> } )
カラム <B> と列 <C> でデータフレーム <A> を逆順にソートし、置き換える	<A> = <A> . sort_values ( [ <B> , <C> ] , ascending = False )	flush = <A> . sort_values ( [ <B> , <C> ] , ascending = False , inplace = True )
一番左の列をインデックスにセットセットして、 <B> データを読み込まれた結果を <A> に代入する	<A> = pd . read_csv ( <B> , index_col = 0 )	markerfacecolor = pd . read_csv ( <A> , index_col = 0 )
データフレーム <A> の列名を <B> から <C> にリネームして、置き換える	<A> = <A> . rename ( columns = { <B> : <C> } )	<B> <A> . rename ( columns = { <B> : <C> } , inplace = True )
<A> 内のそれぞれのカラムに存在する <B> の個数の合計	<A> . isin ( [ <B> ] ) . sum ( )	isin <A> = <B> . isin ( [ <C> ] ) . sum ( )
表データとしてデータ <B> をカンマ区切りで読み込んで、 <A> とする	<A> = pd . read_csv ( <B> , sep = ',' )	markerfacecolor = pd . read_csv ( <A> , sep = ',' )
データフレーム <B> 中のカテゴリーを数値データで置き換えられた結果を <A> とする	<A> = pd . get_dummies ( <B> )	markerfacecolor = pd . get_dummies ( <A> , <B> )
<A> の <B> を欠損値で補い、置き換える	<A> = <A> . replace ( <B> , np . nan )	np . replace ( <A> , <B> , np . nan , inplace = True )
<A> 行に最大行数をセットする	pd . set_option ( 'display.max_rows' , <A> )	start = pd . set_option ( 'display.max_rows' , <A> )
<A> 中の <B> のダブる行を落とした結果で置き換える	<A> . drop_duplicates ( subset = <B> , inplace = True )	<B> <A> = <A> . drop_duplicates ( subset = <B> )
データフレーム <A> のコラム <B> を区間の数を <C> 、ビンのラベルをリスト <D> として分割する	pd . cut ( <A> [ <B> ] , <C> , label = <D> )	<A> = pd . cut ( <B> [ <C> ] , <D> , label = <E> )
データフレーム <A> からファイル <B> という名前で CSV データに変換する	<A> . to_csv ( <B> )	to_csv <A> . to_csv ( <B> )
エクセルファイル <B> の <C> シート名を表に格納した結果を <A> とする	<A> = pd . read_excel ( <B> , sheet_name = <C> )	markerfacecolor = pd . read_excel ( <B> , sheet_name = <C> )
<A> の列の名前を <B> から <C> にリネームする	<A> . rename ( columns = { <B> : <C> } )	} . rename ( columns = { <B> : <C> } )
データフレーム <B> の列の名前を <C> から <D> に変更した結果を <A> にする	<A> = <B> . rename ( columns = { <C> : <D> } )	} = <B> . rename ( columns = { <C> : <D> } )
<B> データを表として読まれた結果を <A> にする	<A> = pd . read_csv ( <B> )	markerfacecolor = <A> . read_csv ( <B> )
<B> コラムと <C> 列が降順になるように <A> データフレーム全体をソートして、再代入する	<A> = <A> . sort_values ( [ <B> , <C> ] , ascending = False )	[ <A> = <A> . sort_values ( [ <B> , <C> ] , ascending = False )
<A> の <B> をインデックスにセットされた結果で置き換える	<A> . set_index ( <B> , inplace = True )	<A> = <A> . set_index ( <B> )
<B> カラムと <C> 列を元に <A> データフレームを逆順でソートし、再代入する	<A> = <A> . sort_values ( [ <B> , <C> ] , ascending = False )	[ <A> = <A> . sort_values ( [ <B> , <C> ] , ascending = False )
<A> 中の欠損を <B> で埋めた結果で置き換える	<A> . fillna ( <B> , inplace = True )	<B> <A> . fillna ( <B> , inplace = True )
<A> というエクセルファイルの <B> を読む	pd . read_excel ( <A> , sheet_name = <B> )	<A> . pd . read_excel ( <B> , sheet_name = <B> )
<B> の <D> に <C> の名前を <E> の名前を <F> にリネームした結果を <A> に代入する	<A> = <B> . rename ( columns = { <C> : <D> , <E> : <F> } )	<A> = <B> . drop_duplicates ( columns = { <C> : <D> , <E> : <F> } )
<A> に x 軸のラベルを指定する	plt . xlabel ( <A> )	pd . xlabel ( <A> )
<A> データフレームを <B> カラムと <C> 列を元に値が大きい順でソートし、置き換える	<A> = <A> . sort_values ( [ <B> , <C> ] , ascending = False )	flush = <A> . sort_values ( [ <B> , <C> ] , ascending = False , inplace = True )
<A> データフレームと <B> データフレームを左側のデータのインデックスと右側のデータの <C> カラムをキーとしてマージする	pd . merge ( <A> , <B> , left_index = True , right_on = <C> )	<A> . pd . merge ( <B> , <C> , left_index = True , right_on = <D> )
<A> データフレーム中の <B> を未記入の値に置換し未記入の値がある行を落とされた結果を再代入する	<A> = <A> . replace ( <B> , np . nan ) . dropna ( )	plt . replace ( <A> , <B> , np . nan ) . dropna ( inplace = True )
データフレーム <A> 内の重複した行の数を調べる	<A> . duplicated ( ) . sum ( )	<B> <A> = <A> . duplicated ( ) . sum ( )
<A> の中の未入力の値が存在する行を落とし、再代入する	<A> = <A> . dropna ( )	errors = <A> . dropna ( )
<A> を y 座標、 <B> を x 座標として、グラフを表示する	plt . plot ( <A> , <B> )	<A> = pd . plot ( <B> ) . mean ( )
<A> データフレーム中の <B> コラムと <C> カラムに重複はあるのかどうか	<A> . duplicated ( subset = [ <B> , <C> ] )	<B> <A> . duplicated ( subset = [ <C> , <D> ] )
グラフの x 軸の軸の名前を <A> にセットする	plt . xlabel ( <A> )	<A> = pd . xlabel ( <B> )
<A> データフレーム内の未入力の値がある行をドロップし、 <A> にする	<A> = <A> . dropna ( )	errors = <A> . dropna ( )
<A> 中の欠損を <B> で置き換えて、置き換える	<A> . fillna ( <B> , inplace = True )	flush = <A> . fillna ( <B> )
ビン数を <D> として <B> データフレームの <C> コラムを分割した結果を <A> に代入する	<A> = pd . cut ( <B> [ <C> ] , <D> )	markerfacecolor = pd . cut ( <B> [ <C> ] , <D> )
データフレーム <A> 中の未記入の値を <B> で埋められた結果を再代入する	<A> = <A> . fillna ( <B> )	plt . fillna ( <A> , <B> , inplace = True )
データフレーム <A> の中で重複した行の合計を見る	<A> . duplicated ( ) . sum ( )	pd . duplicated ( ) . sum ( )
点のマーカーの種類を使う	marker = '.'	autopct = '.'
<A> データフレームの <B> を NaN に置換した結果で置き換える	<A> . replace ( <B> , np . nan , inplace = True )	np . replace ( <A> , <B> , np . nan , inplace = True )
エクセルファイル <B> の <C> 番目のシートから表を読んで、 <A> にする	<A> = pd . read_excel ( <B> , sheet_name = <C> )	markerfacecolor = pd . read_excel ( <B> , sheet_name = <C> )
<A> データフレームの <B> を欠損値に置換した結果で置き換える	<A> . replace ( <B> , np . nan , inplace = True )	np . replace ( <A> , <B> , np . nan , inplace = True )
カラム <B> と列 <C> を軸にデータフレーム <A> を降順でソートして、 <A> とする	<A> = <A> . sort_values ( [ <B> , <C> ] , ascending = False )	[ <A> = <A> . sort_values ( [ <B> , <C> ] , ascending = False )
データフレーム <B> 内のコラム <C> の重複している行を削除して、 <A> とする	<A> = <B> . drop_duplicates ( subset = <C> )	markeredgecolor = <B> . drop_duplicates ( subset = <C> )
<C> に <A> の <B> の名前をリネームした結果を再代入する	<A> = <A> . rename ( index = { <B> : <C> } )	{ <A> = <A> . rename ( columns = { <B> : <C> } )
データフレーム <A> 内の重複要素がある行を削除して、インプレースする	<A> . drop_duplicates ( inplace = True )	inplace <A> = <A> . drop_duplicates ( )
<A> と <B> の垂直棒グラフを真ん中として棒グラフの位置を描写する	plt . bar ( <A> , <B> , align = 'center' )	bar plt . bar ( <A> , <B> , align = 'center' )
凡例を最も適切な位置に描く	plt . legend ( loc = 'best' )	<A> = plt . legend ( loc = 'best' )
<A> の <B> と <C> ごとの <D> の値の合計を求める	<A> . groupby ( [ <B> , <C> ] ) [ <D> ] . sum ( )	<B> <A> = <B> . groupby ( [ <C> , <D> ] ) . sum ( )
グラフのラベルを <A> とする	labels = <A>	encoding = <A>
<A> データフレームの <B> コラムをビンを <C> 、ビンのラベルを整数値として分割する	pd . cut ( <A> [ <B> ] , <C> , label = False )	<A> . pd . cut ( <B> [ <C> ] , <D> , label = False )
存在する <B> を <A> 中に NaN とした結果を再代入する	<A> = <A> . replace ( <B> , np . nan )	nan <A> = <A> . replace ( <B> , np . nan )
<B> と <C> で <A> を逆順にソートした結果で置き換える	<A> . sort_values ( [ <B> , <C> ] , ascending = False , inplace = True )	flush = <A> . sort_values ( [ <B> , <C> ] , ascending = False , inplace = True )
フォーマットをデータフレーム <A> のカラム <B> を datetime 型にする	pd . to_datetime ( <A> [ <B> ] , format = '%Y-%m-%d' )	'%Y-%m-%d' = pd . to_datetime ( <A> [ <B> ] , format = '%Y-%m-%d' )
データフレーム <A> をコラム <B> を軸に昇順でソートされた結果を再代入する	<A> = <A> . sort_values ( <B> )	range = <A> . sort_values ( <B> )
<B> をインデックスを元に昇順でソートして、 <A> にする	<A> = <B> . sort_index ( )	markerfacecolor = <B> . sort_index ( )
<A> のインデックスを振り直された結果を <A> とする	<A> = <A> . reset_index ( )	xticks <A> = <A> . reset_index ( )
データフレーム <B> の列の名前を <C> から <D> に <E> から <F> にリネームされた結果を <A> とする	<A> = <B> . rename ( columns = { <C> : <D> , <E> : <F> } )	<A> = <B> . drop_duplicates ( columns = { <C> : <D> , <E> : <F> } )
データフレーム <B> のコラム <C> をビン数を <D> 、ビンのラベルを整数値として分割した結果を <A> に代入する	<A> = pd . cut ( <B> [ <C> ] , <D> , label = False )	[ <A> = pd . cut ( <B> [ <C> ] , <D> , label = False )
データフレーム <A> 中の欠損を削除した結果で置き換える	<A> = <A> . dropna ( )	dropna = <A> . dropna ( )
データフレーム <A> 内のカテゴリーを one - hot 表現に変換する	pd . get_dummies ( <A> )	get_dummies = pd . get_dummies ( <A> )
エクセルファイル <B> の <C> を表にした結果を <A> にする	<A> = pd . read_excel ( <B> , sheet_name = <C> )	markerfacecolor = pd . read_excel ( <B> , sheet_name = <C> )
列番号 <B> をインデックスとして、データ <A> をデータフレームとして読む	pd . read_csv ( <A> , index_col = <B> )	<A> . pd . read_csv ( <B> , index_col = <C> )
データフレーム <A> 中に重複があるのかどうか確認を表示する	<A> . duplicated ( )	duplicated <A> . duplicated ( )
<A> 全体をインデックスで順番になるようにソートされた結果を <A> に代入する	<A> = <A> . sort_index ( )	sort_index = <A> . sort_index ( )
データフレーム <A> 中のコラムに存在する <B> の個数の和	<A> . isin ( [ <B> ] ) . sum ( )	isin <A> [ <B> ] . sum ( )
<B> を表として読み込んで、 <A> に代入する	<A> = pd . read_csv ( <B> )	markerfacecolor = <A> . read_csv ( <B> )
<A> データフレームをインデックスで値が小さい順に並び替えた結果を <A> にする	<A> = <A> . sort_index ( )	sort_index = <A> . sort_index ( )
<B> の中の <C> を未入力の値に置き換え未入力の値がある行を取り除かれた結果を <A> とする	<A> = <B> . replace ( <C> , np . nan ) . dropna ( )	marker = <B> . replace ( <C> , np . nan ) . dropna ( )
<A> の <B> を削除された結果でインプレースする	<A> . drop ( <B> , axis = 1 , inplace = True )	pd . merge ( <A> , <B> , axis = 1 , inplace = True )
<A> データフレーム中の <B> 列と <C> 列に重複はあるのかどうか検出する	<A> . duplicated ( subset = [ <B> , <C> ] )	alpha = <A> . duplicated ( subset = [ <B> , <C> ] )
箱ひげ図を用いて <A> をプロットする	plt . boxplot ( <A> )	pd . boxplot ( <A> )
エクセルファイル <A> の <B> 番目のシートをデータフレームに読み込む	pd . read_excel ( <A> , sheet_name = <B> )	<A> . pd . read_excel ( <B> , sheet_name = <C> )
データフレーム <A> の中にある <B> を未記入の値として、 <A> とする	<A> = <A> . replace ( <B> , np . nan )	nan <A> = <A> . replace ( <B> , np . nan )
<B> を <C> をもとに昇順でソートした結果を <A> とする	<A> = <B> . sort_values ( <C> )	markerfacecolor = <B> . sort_values ( <C> )
線の形状は破線を使う	linestyle = 'dashed'	cut = 'dashed'
<A> の中の <B> を未入力の値に置換し未入力の値がある行を取り除いた結果を再代入する	<A> = <A> . replace ( <B> , np . nan ) . dropna ( )	plt . replace ( <A> , <B> , np . nan ) . dropna ( inplace = True )
<A> データフレームの <B> を NaN で補って、置き換える	<A> . replace ( <B> , np . nan , inplace = True )	plt . replace ( <A> , <B> , np . nan , inplace = True )
<A> データフレームを <B> ファイルに設定して保存する	<A> . to_csv ( <B> )	plt . to_csv ( <A> , <B> , to_csv = '
<C> から <D> にデータフレーム <B> の列名を変更された結果を <A> にする	<A> = <B> . rename ( columns = { <C> : <D> } )	} = <B> . rename ( columns = { <C> : <D> } )
データフレーム <A> 中の <B> を NaN に置き換え NaN がある行を消す	<A> . replace ( <B> , np . nan ) . dropna ( )	replace <A> . replace ( <B> , np . nan ) . dropna ( )
ある <C> を <B> 中に NaN で置き換え、 <A> にする	<A> = <B> . replace ( <C> , np . nan )	<B> <A> = <B> . replace ( <C> , np . nan )
カラム <B> と列 <C> を元にデータフレーム <A> を降順でソートした結果で置き換える	<A> = <A> . sort_values ( [ <B> , <C> ] , ascending = False )	flush = <A> . sort_values ( [ <B> , <C> ] , ascending = False , inplace = True )
データフレーム <A> の <B> を欠損値にした結果を再代入する	<A> = <A> . replace ( <B> , np . nan )	nan <A> = <A> . replace ( <B> , np . nan )
<A> データフレーム内の欠損が存在する行を削除した結果を <A> にする	<A> = <A> . dropna ( )	errors = <A> . dropna ( )
<B> から <C> に <A> のカラム名をした結果で置き換える	<A> . rename ( columns = { <B> : <C> } , inplace = True )	<B> <A> . rename ( columns = { <B> : <C> } , inplace = True )
エクセルファイル <A> の <B> シート名を読み込み、表データとする	pd . read_excel ( <A> , sheet_name = <B> )	<A> . pd . read_excel ( <B> , sheet_name = <B> )
<A> データフレームの <B> コラムをインデックスとして指定した結果を <A> とする	<A> = <A> . set_index ( <B> )	plt . set_index ( <A> , <B> , align = True )
<A> データフレームの中の <B> コラムに重複がある行を取り除いて、書き換える	<A> . drop_duplicates ( subset = <B> , inplace = True )	drop_duplicates = <A> . drop_duplicates ( subset = <B> , inplace = True )
<B> と <C> が逆順になるように <A> 全体をソートした結果で置き換える	<A> . sort_values ( [ <B> , <C> ] , ascending = False , inplace = True )	flush = <A> . sort_values ( [ <B> , <C> ] , ascending = False , inplace = True )
<B> から <C> に <A> の行名をリネームし、置き換える	<A> = <A> . rename ( index = { <B> : <C> } )	<A> . rename ( index = { <B> : <C> } , inplace = True )
データフレーム <A> のカラム名を <B> から <C> に変更し、置き換える	<A> . rename ( columns = { <B> : <C> } , inplace = True )	<B> <A> . rename ( columns = { <B> : <C> } , inplace = True )
<A> データフレーム中の欠損を <B> とされた結果で置き換える	<A> . fillna ( <B> , inplace = True )	flush = <A> . fillna ( <B> )
マーカーの形を★とする	marker = '*'	markerfacecolor = '*'
<A> データフレームをインデックスで並び替えた結果で置き換える	<A> . sort_index ( inplace = True )	kind = <A> . sort_index ( )
<A> の <B> を未入力の値に置き換えた結果を <A> にする	<A> = <A> . replace ( <B> , np . nan )	nan <A> = <A> . replace ( <B> , np . nan )
<B> データフレーム内の欠損を <C> に置換して、 <A> に代入する	<A> = <B> . fillna ( <C> )	markeredgecolor = <B> . fillna ( <C> )
カラム <B> と列 <C> を元にデータフレーム <A> を降順でソートする	<A> . sort_values ( [ <B> , <C> ] , ascending = False )	ascending . sort_values ( [ <A> [ <B> , <C> ] , ascending = False )
<B> データフレーム全体をインデックスに基づき昇順でソートし、 <A> にする	<A> = <B> . sort_index ( )	markerfacecolor = <B> . sort_index ( )
x 座標に <A> という軸名を追加する	plt . xlabel ( <A> )	pd . xlabel ( <A> )
<B> データフレームの中の未入力の値が存在する行を取り除いて、 <A> にする	<A> = <B> . dropna ( )	errors = <B> . dropna ( )
<B> の列名を <C> から <D> にして、 <A> に代入する	<A> = <B> . rename ( columns = { <C> : <D> } )	} = { <B> . rename ( columns = { <C> : <D> } )
データフレーム <A> の中のコラム <B> に重複がある行を落とした結果で置き換える	<A> = <A> . drop_duplicates ( subset = <B> )	<B> <A> = <A> . drop_duplicates ( subset = <B> )
エンコーディングをシフト JIS として、データ <A> を読み込む	pd . read_csv ( <A> , encoding = 'shift_jis' )	encoding = pd . read_csv ( <A> , encoding = 'shift_jis' )
エクセルファイル <B> の <C> シート名を指定して読み込んだ結果を <A> とする	<A> = pd . read_excel ( <B> , sheet_name = <C> )	markerfacecolor = pd . read_excel ( <B> , sheet_name = <C> )
データフレーム <A> をカラム <B> と列 <C> を元に値が大きい順でソートされた結果で置き換える	<A> . sort_values ( [ <B> , <C> ] , ascending = False , inplace = True )	flush = <A> . sort_values ( [ <B> , <C> ] , ascending = False , inplace = True )
ある <C> をデータフレーム <B> 中に未記入の値に置き換え、 <A> に代入する	<A> = <B> . replace ( <C> , np . nan )	replace <A> = <B> . replace ( <C> , np . nan )
<B> で昇順に <A> 全体をソートし、再代入する	<A> = <A> . sort_values ( <B> )	plt . sort_values <A> <B> , inplace = True )
<A> 内に存在する <B> を欠損に置換した結果を <A> にする	<A> = <A> . replace ( <B> , np . nan )	nan <A> = <A> . replace ( <B> , np . nan )
<B> データフレームについてダミー変数を作り、 <A> とする	<A> = pd . get_dummies ( <B> )	markerfacecolor = pd . get_dummies ( <A> , <B> )
<B> の <C> をビンに含まれる個数が等しくなるように区間の数を <D> として分割し、 <A> に代入する	<A> = pd . qcut ( <B> [ <C> ] , <D> )	marker = pd . qcut ( <B> [ <C> ] , <D> )
バツ印のマーカーの形状を用いる	marker = 'x'	sheet_name = 'x'
打点を円とする	marker = 'o'	markerfacecolor = 'o'
先頭の列をインデックスとして、データ <A> をデータフレームとして読み込む	pd . read_csv ( <A> , index_col = 0 )	0 = pd . read_csv ( <A> , index_col = 0 )
<A> データフレーム中の未記入の値を <B> で埋め、再代入する	<A> = <A> . fillna ( <B> )	plt . fillna ( <A> , <B> , inplace = True )
データフレーム <A> の <B> が <C> 以下のデータ	<A> [ <A> [ <B> ] <= <C> ]	plt . qcut ( <A> [ <B> ] , <C> )
<A> 内に存在する <B> を欠損値として、置き換える	<A> . replace ( <B> , np . nan , inplace = True )	np . replace ( <A> , <B> , np . nan , inplace = True )
区関数を <D> としてビンに含まれる個数が等しくなるように <B> データフレームの <C> コラムを分割された結果を <A> にする	<A> = pd . qcut ( <B> [ <C> ] , <D> )	marker = pd . qcut ( <B> [ <C> ] , <D> )
<A> 内の欠損を <A> の平均値で埋める	<A> . fillna ( <A> . mean ( ) )	<A> . groupby ( [ <B> , <C> ] ) [ <D> ] . mean ( )
左側のデータのインデックスと <C> カラムをキーとして <A> データフレームと <B> データフレームをマージする	pd . merge ( <A> , <B> , left_index = True , right_on = <C> )	<A> . pd . merge ( <B> , <C> , left_index = True , right_on = <D> )
エクセルファイル <B> の <C> を読み込み、データフレームに格納し、 <A> に代入する	<A> = pd . read_excel ( <B> , sheet_name = <C> )	marker = pd . read_excel ( <B> , sheet_name = <C> )
<A> データフレーム中の未記入の値を <A> データフレームの平均で補い、置き換える	<A> = <A> . fillna ( <A> . mean ( ) )	pd . fillna ( <A> . mean ( ) , inplace = True )
データフレーム <B> のコラム <C> を要素の数が等しくなるように区関数を <D> として分割した結果を <A> にする	<A> = pd . qcut ( <B> [ <C> ] , <D> )	marker = pd . qcut ( <B> [ <C> ] , <D> )
<A> データフレーム中の <B> を NaN に置き換え NaN が存在する行を消し、置き換える	<A> . replace ( <B> , np . nan ) . dropna ( inplace = True )	<A> = <A> . replace ( <B> , np . nan ) . dropna ( )
<A> 中の <B> を欠損に変え欠損が存在する行を削除された結果を再代入する	<A> = <A> . replace ( <B> , np . nan ) . dropna ( )	plt . replace ( <A> , <B> , np . nan ) . dropna ( inplace = True )
<B> データフレームを <C> コラムを使って昇順でソートし、 <A> にする	<A> = <B> . sort_values ( <C> )	markerfacecolor = <B> . sort_values ( <C> )
<B> の中にある <C> を未入力の値に置き換えた結果を <A> に代入する	<A> = <B> . replace ( <C> , np . nan )	<B> <A> = <B> . replace ( <C> , np . nan )
<B> データフレーム中の未記入の値を <C> で置き換えて、 <A> に代入する	<A> = <B> . fillna ( <C> )	markeredgecolor = <B> . fillna ( <C> )
CSV ファイル <A> をタブ区切りで読み込む	pd . read_csv ( <A> , sep = '\t' )	sep = pd . read_csv ( <A> , sep = '\t' )
データフレーム <A> をインデックスを元に小さい方からソートした結果を <A> に代入する	<A> = <A> . sort_index ( )	sort_index = <A> . sort_index ( )
データフレーム <A> 内の欠損値を <B> とする	<A> . fillna ( <B> )	plt . fillna ( <A> , <B> )
インデックスを元にデータフレーム <A> を小さい方からソートして、再代入する	<A> = <A> . sort_index ( )	sort_index = <A> . sort_index ( )
重複した最後の行を残してデータフレーム <B> 内の重複している行をドロップされた結果を <A> に代入する	<A> = <B> . drop_duplicates ( keep = False )	markeredgecolor = <B> . drop_duplicates ( keep = False )
<A> の列名を <D> から <E> に <B> から <C> にリネームされた結果を <A> に代入する	<A> = <A> . rename ( columns = { <B> : <C> , <D> : <E> } )	<B> <A> . rename ( columns = { <B> : <C> , <D> : <E> } , inplace = True )
<B> データフレームの <C> を欠損値で埋めた結果を <A> にする	<A> = <B> . replace ( <C> , np . nan )	<B> <A> = <B> . replace ( <C> , np . nan )
データフレーム <B> の <C> を未入力の値で補い、 <A> にする	<A> = <B> . replace ( <C> , np . nan )	<B> <A> = <B> . replace ( <C> , np . nan )
<A> データフレームの <B> を未記入の値で置き換え、 <A> に代入する	<A> = <A> . replace ( <B> , np . nan )	nan <A> = <A> . replace ( <B> , np . nan )
<A> データフレーム全体を <B> コラムを軸に昇順でソートし、置き換える	<A> . sort_values ( <B> , inplace = True )	<A> = <A> . sort_values ( <B> )
データフレーム <B> とデータフレーム <C> を横方向に結合を <A> に代入する	<A> = pd . merge ( <B> , <C> )	pd . merge ( <A> , <B> , on = <C> )
カラム <B> と列 <C> でデータフレーム <A> を逆順にソートし、 <A> に代入する	<A> = <A> . sort_values ( [ <B> , <C> ] , ascending = False )	[ <A> = <A> . sort_values ( [ <B> , <C> ] , ascending = False )
<A> データフレームをインデックスにそって昇順でソートして、 <A> にする	<A> = <A> . sort_index ( )	sort_index = <A> . sort_index ( )
区間を <D> 、ビンの名前を整数値としてデータフレーム <B> のコラム <C> を分割して、 <A> にする	<A> = pd . cut ( <B> [ <C> ] , <D> , label = False )	[ <A> = pd . cut ( <B> [ <C> ] , <D> , label = False )
<A> データフレーム内の欠損値の合計を見る	<A> . isnull ( ) . sum ( )	plt . isnull ( ) . sum ( )
<A> データフレームの <B> カラムの曜日	<A> [ <B> ] . dt . weekday_name	<A> [ [ <B> ] . dt . weekday_name
<A> 内に存在する <B> を欠損値とした結果を <A> に代入する	<A> = <A> . replace ( <B> , np . nan )	nan <A> = <A> . replace ( <B> , np . nan )
<A> を <B> というファイル名でエクセル形式に書き込む	<A> . to_excel ( <B> )	range = ( <A> [ <B> ] )
<A> の <B> を日付型に変換する	pd . to_datetime ( <A> [ <B> ] )	range = ( <A> [ <B> ] )
<A> データフレーム中のそれぞれのコラムにある <B> の個数をチェックする	<A> . isin ( [ <B> ] ) . sum ( )	isin <A> = <B> . isin ( [ <C> ] ) . sum ( )
カラム <B> と列 <C> を軸にデータフレーム <A> を値が大きい順でソートされた結果で置き換える	<A> = <A> . sort_values ( [ <B> , <C> ] , ascending = False )	flush = <A> . sort_values ( [ <B> , <C> ] , ascending = False , inplace = True )
データフレーム <A> 中の未記入の値がある行を消す	<A> . dropna ( )	plt . dropna ( )
片方のテーブルにしかないデータも全て残して <A> と <B> をマージする	pd . merge ( <A> , <B> , how = 'outer' )	alpha = pd . merge ( <A> , <B> , how = 'outer' )
<A> データフレーム内のカラムに存在する <B> の個数の合計値	<A> . isin ( [ <B> ] ) . sum ( )	isin <A> [ <B> ] . sum ( )
ビンを <D> 、ビンのラベルをインデックスとして <B> データフレームの <C> コラムを分割して、 <A> にする	<A> = pd . cut ( <B> [ <C> ] , <D> , label = False )	[ <A> = pd . cut ( <B> [ <C> ] , <D> , label = False )
<A> データフレームの中の未記入の値を落とし、置き換える	<A> = <A> . dropna ( )	dropna = <A> . dropna ( )
分割数を <D> として <B> データフレームの <C> コラムを分割された結果を <A> とする	<A> = pd . cut ( <B> [ <C> ] , <D> )	[ <A> = pd . cut ( <B> [ <C> ] , <D> )
<A> データフレームの <B> コラムと <C> を消し、置き換える	<A> . drop ( [ <B> , <C> ] , axis = 1 , inplace = True )	<A> = <A> . drop ( [ <B> , <C> ] , axis = 1 )
<A> データフレーム内の欠損を <B> とし、 <A> とする	<A> = <A> . fillna ( <B> )	plt . fillna ( <A> , <B> , inplace = True )
<A> データフレーム内のカテゴリーを one - hot 表現にする	pd . get_dummies ( <A> )	get_dummies = pd . get_dummies ( <A> )
<A> の未記入の値がある行を落とした結果で置き換える	<A> = <A> . dropna ( )	dropna = <A> . dropna ( )
エクセルファイル <B> の <C> シート名を表に読み込んだ結果を <A> とする	<A> = pd . read_excel ( <B> , sheet_name = <C> )	markerfacecolor = pd . read_excel ( <B> , sheet_name = <C> )
データフレーム <A> の列 <B> とコラム <C> を降順にソートされた結果を <A> に代入する	<A> = <A> . sort_values ( [ <B> , <C> ] , ascending = False )	[ <A> = <A> . sort_values ( [ <B> , <C> ] , ascending = False )
データフレーム <A> をファイル <B> に書き出す	<A> . to_csv ( <B> )	markerfacecolor = <A> . to_csv ( <B> )
<A> 中の未記入の値を <B> に置き換える	<A> . fillna ( <B> )	plt . fillna ( <A> [ <B> ] )
<A> 内の欠損を削除して、 <A> に代入する	<A> = <A> . dropna ( )	autopct = <A> . dropna ( )
<B> ファイルという名前の CSV ファイルとして <A> データフレームを保存する	<A> . to_csv ( <B> )	to_csv <A> . to_csv ( <B> )
<B> と <C> を縦向きでくっつけられた結果を <A> とする	<A> = pd . concat ( [ <B> , <C> ] )	markerfacecolor = pd . concat ( [ <A> , <B> , <C> ] )
<B> の中の重複要素がある行を取り除いて、 <A> とする	<A> = <B> . drop_duplicates ( )	mode = <B> . drop_duplicates ( )
表データとして <A> データをカンマ区切りで読み込む	pd . read_csv ( <A> , sep = ',' )	<A> . pd . read_csv ( <B> , sep = ',' )
ある <B> を <A> の中に未記入の値に置き換えた結果を再代入する	<A> = <A> . replace ( <B> , np . nan )	nan <A> = <A> . replace ( <B> , np . nan )
データフレーム <A> 内の欠損値を <B> とし、置き換える	<A> = <A> . fillna ( <B> )	<B> <A> . fillna ( <B> , inplace = True )
ある <C> を <B> の中に未入力の値で置き換えた結果を <A> に代入する	<A> = <B> . replace ( <C> , np . nan )	<B> <A> = <B> . replace ( <C> , np . nan )
<C> から <D> にデータフレーム <B> の行名をリネームし、 <A> に代入する	<A> = <B> . rename ( index = { <C> : <D> } )	markeredgecolor = <B> . rename ( index = { <C> : <D> } )
<B> の中のカテゴリ変数を one - hot 表現に変換した結果を <A> に代入する	<A> = pd . get_dummies ( <B> )	markerfacecolor = pd . get_dummies ( <A> , <B> )
データフレーム <B> の <C> を未記入の値に置き換え、 <A> とする	<A> = <B> . replace ( <C> , np . nan )	<B> <A> = <B> . replace ( <C> , np . nan )
カラム <B> と列 <C> を元にデータフレーム <A> 全体を降順でソートし、置き換える	<A> . sort_values ( [ <B> , <C> ] , ascending = False , inplace = True )	flush = <A> . sort_values ( [ <B> , <C> ] , ascending = False , inplace = True )
<A> 番まで列を表示できるように指定する	pd . set_option ( 'display.max_columns' , <A> )	'display.max_columns' = pd . set_option ( 'display.max_columns' , <A> )
<A> の欠損を <B> に変える	<A> . fillna ( <B> )	plt . fillna ( <A> , <B> )
<A> というエクセルファイルのシート名 <B> を読む	pd . read_excel ( <A> , sheet_name = <B> )	<A> . pd . read_excel ( <B> , sheet_name = <B> )
<A> データフレームについてダミー変数を生成する	pd . get_dummies ( <A> )	get_dummies = pd . get_dummies ( <A> )
<A> と <B> と <C> についての箱ひげ図をプロットする	plt . boxplot ( [ <A> , <B> , <C> ] )	<A> = plt . boxplot ( [ <B> , <C> ] )
データフレーム <A> 内のコラム <B> とカラム <C> に重複はあるのかどうか	<A> . duplicated ( subset = [ <B> , <C> ] )	<B> <A> . duplicated ( subset = [ <C> ] )
エンコーディングを shift - jis として、 <A> データを読み込む	pd . read_csv ( <A> , encoding = 'shift_jis' )	encoding = pd . read_csv ( <A> , encoding = 'shift_jis' )
データフレーム <B> 全体をインデックスに基づき昇順でソートした結果を <A> にする	<A> = <B> . sort_index ( )	markerfacecolor = <B> . sort_index ( )
データフレーム <A> 中の <B> を未記入の値に置き換え未記入の値がある行を落とした結果で置き換える	<A> = <A> . replace ( <B> , np . nan ) . dropna ( )	<A> . replace ( <B> , np . nan ) . dropna ( inplace = True )
<B> データフレーム全体をインデックスを元に昇順でソートした結果を <A> に代入する	<A> = <B> . sort_index ( )	markerfacecolor = <B> . sort_index ( )
<B> データフレームの <D> に <C> コラムの名前を <F> に <E> 列の名前をリネームし、 <A> に代入する	<A> = <B> . rename ( columns = { <C> : <D> , <E> : <F> } )	<A> = <B> . drop_duplicates ( columns = { <C> : <D> , <E> : <F> } )
<A> データフレームを <B> ファイルにして保存する	<A> . to_csv ( <B> )	plt . to_csv ( <A> , <B> , to_csv = '
データフレーム <A> 中のコラム <B> に重複がある行を落とされた結果でインプレースする	<A> . drop_duplicates ( subset = <B> , inplace = True )	drop_duplicates = <A> . drop_duplicates ( subset = <B> , inplace = True )
コラム <B> と列 <C> が値の大きい順になるようにデータフレーム <A> をソートされた結果で置き換える	<A> = <A> . sort_values ( [ <B> , <C> ] , ascending = False )	flush = <A> . sort_values ( [ <B> , <C> ] , ascending = False , inplace = True )
インデックスを軸に <A> データフレームを小さい順でソートされた結果を再代入する	<A> = <A> . sort_index ( )	sort_index = <A> . sort_index ( )
<B> から <C> にデータフレーム <A> の列の名前をする	<A> . rename ( columns = { <B> : <C> } )	} = <B> . rename ( columns = { <C> : <D> } )
UTF8 を用いる	encoding = 'utf-8'	buffering = 'utf-8'
ダブる最後の行を残して <A> データフレーム中の重複している行を落とし、インプレースする	<A> . drop_duplicates ( keep = False , inplace = True )	<B> <A> . drop_duplicates ( keep = False , inplace = True )
エクセル <B> を表データとして読んだ結果を <A> とする	<A> = pd . read_excel ( <B> )	markerfacecolor = pd . read_excel ( <A> , <B> )
<A> 中の重複要素がある行を削除した結果を <A> とする	<A> = <A> . drop_duplicates ( )	xticks <A> = <A> . drop_duplicates ( )
<A> データフレームの <B> を NaN で置き換えられた結果を <A> とする	<A> = <A> . replace ( <B> , np . nan )	nan <A> = <A> . replace ( <B> , np . nan )
<A> から表をカンマ区切りで読み込む	pd . read_csv ( <A> , sep = ',' )	kind = pd . read_csv ( <A> , sep = ',' )
<B> の中の <C> に重複がある行を落として、 <A> とする	<A> = <B> . drop_duplicates ( subset = <C> )	markerfacecolor = <B> . drop_duplicates ( subset = <C> )
<A> データフレームの中の未記入の値を直前の行の値で補い、置き換える	<A> . fillna ( method = 'ffill' , inplace = True )	<B> <A> . fillna ( method = 'ffill' , inplace = True )
<C> から <D> に <B> の列名を変更し、 <A> に代入する	<A> = <B> . rename ( columns = { <C> : <D> } )	} = <B> . rename ( columns = { <C> : <D> } )
棒グラフの位置を真ん中として <A> 軸を <A> とした <B> の横方向の棒グラフを表示する	plt . barh ( <A> , <B> , align = 'center' )	kind = pd . read_csv ( <B> , sep = 'center' )
データフレーム <A> をインデックスを元にソートし、置き換える	<A> = <A> . sort_index ( )	kind = <A> . sort_index ( )
エクセルファイル <B> の <C> 番目のシートを読み込んで表データに格納された結果を <A> とする	<A> = pd . read_excel ( <B> , sheet_name = <C> )	marker = pd . read_excel ( <B> , sheet_name = <C> )
<A> にある欠損値の個数	<A> . isnull ( ) . sum ( )	isnull <A> . isnull ( ) . sum ( )
<A> データフレームについてダミー変数を作る	pd . get_dummies ( <A> )	get_dummies = pd . get_dummies ( <A> )
<B> 内の NaN がある行を削除した結果を <A> に代入する	<A> = <B> . dropna ( )	dropna <A> = <B> . dropna ( )
<A> の中の未記入の値を <A> の平均で補って、インプレースする	<A> . fillna ( <A> . mean ( ) , inplace = True )	pd . fillna ( <A> . mean ( ) , inplace = True )
<A> 中の <B> に重複がある行を削除した結果を <A> に代入する	<A> = <A> . drop_duplicates ( subset = <B> )	markerfacecolor = <A> . drop_duplicates ( subset = <B> )
<A> データフレーム内の <B> コラムと <C> カラムに重複はあるのかどうかを見る	<A> . duplicated ( subset = [ <B> , <C> ] )	<B> <A> . duplicated ( subset = [ <C> , <D> ] )
<B> データフレームの <C> を欠損で補われた、結果を <A> に代入する	<A> = <B> . replace ( <C> , np . nan )	<B> <A> = <B> . replace ( <C> , np . nan )
カラム <B> と列 <C> でデータフレーム <A> を降順にソートされた結果を <A> にする	<A> = <A> . sort_values ( [ <B> , <C> ] , ascending = False )	[ <A> = <A> . sort_values ( [ <B> , <C> ] , ascending = False )
<A> 内のそれぞれのカラムにある <B> の個数の合計値を調べる	<A> . isin ( [ <B> ] ) . sum ( )	isin <A> = <B> . isin ( [ <C> ] ) . sum ( )
インデックスを元に <A> 全体を昇順でソートし、 <A> にする	<A> = <A> . sort_index ( )	sort_index = <A> . sort_index ( <A> . mean ( )
データフレーム <B> のカラム <C> の月を <A> とする	<A> = <B> [ <C> ] . dt . month	mode = <B> [ <C> ] . dt . weekday_name
データフレームを <B> からタブ区切りで読み込み、 <A> にする	<A> = pd . read_csv ( <B> , sep = '\t' )	plt . read_csv ( <A> , sep = '\t' )
<B> から <C> にデータフレーム <A> の列名をリネームする	<A> . rename ( columns = { <B> : <C> } )	<B> <A> . rename ( columns = { <B> : <C> } )
<A> データフレーム中の重複要素がある行を消し、置き換える	<A> . drop_duplicates ( inplace = True )	kind = <A> . drop_duplicates ( )
<B> の <E> について <C> をインデックス、 <D> をカラムとしたピボットテーブルを作成した結果を <A> にする	<A> = <B> . pivot_table ( index = <C> , columns = <D> , values = <E> )	pivot_table <A> = <B> . pivot_table ( columns = <C> , values = <D> )
エクセルファイル <A> の <B> シート名から表を読み込む	pd . read_excel ( <A> , sheet_name = <B> )	sheet_name = pd . read_excel ( <A> , sheet_name = <B> )
<A> データフレームでダブっているものがあるかどうか確認する	<A> . duplicated ( )	duplicated <A> . duplicated ( )
<A> 列目までを見れるように指定する	pd . set_option ( 'display.max_columns' , <A> )	'display.max_columns' = pd . set_option ( 'display.max_columns' , <A> )
データフレーム <A> 内の重複している行を削除する	<A> . drop_duplicates ( )	pd . drop_duplicates ( <A> )
<A> を <B> に書き込む	<A> . to_csv ( <B> )	range = <A> . to_csv ( <B> )
<B> の <E> について <C> をインデックス、 <D> を列としたピボットテーブルを作成された結果を <A> とする	<A> = <B> . pivot_table ( index = <C> , columns = <D> , values = <E> )	pivot_table <A> = <B> . pivot_table ( columns = <C> , values = <D> )
<A> 内の欠損を <A> の平均をとって埋めた結果で置き換える	<A> = <A> . fillna ( <A> . mean ( ) )	kind = <A> . fillna ( <A> . mean ( ) )
<A> 中のカテゴリーを数値にする	pd . get_dummies ( <A> )	get_dummies = pd . get_dummies ( <A> )
データ <B> を <C> 区切りで読んだ結果を <A> にする	<A> = pd . read_csv ( <B> , sep = <C> )	pd . read_csv ( <A> , sep = <B> )
<A> と <B> と <C> を箱ひげ図に描写する	plt . boxplot ( [ <A> , <B> , <C> ] )	kind = pd . boxplot ( [ <B> , <C> ] )
<B> 内の欠損値を <C> に置き換え、 <A> にする	<A> = <B> . fillna ( <C> )	markeredgecolor = <B> . fillna ( <C> )
データフレーム <A> のコラム <B> をインデックスとして変更し、再代入する	<A> = <A> . set_index ( <B> )	plt . set_index ( <A> , <B> , inplace = True )
左側の表データに合わせてデータフレーム <A> とデータフレーム <B> をマージする	pd . merge ( <A> , <B> , how = 'left' )	alpha = pd . merge ( <A> , <B> , how = 'left' )
<B> で <A> を昇順にソートし、 <A> にする	<A> = <A> . sort_values ( <B> )	plt . sort_values <A> <B> , inplace = True )
<B> データフレームの <C> を未記入の値で補った結果を <A> に代入する	<A> = <B> . replace ( <C> , np . nan )	<B> <A> = <B> . replace ( <C> , np . nan )
区間を <C> 、ビンの名前を <D> リストとして <A> データフレームの <B> コラムを分割する	pd . cut ( <A> [ <B> ] , <C> , label = <D> )	<A> = pd . cut ( <B> [ <C> ] , <D> , label = <E> )
データフレーム <A> 中の未記入の値を直前の行の値で埋める	<A> . fillna ( method = 'ffill' )	<B> <A> . fillna ( method = 'ffill' )
線グラフの種類は箱髭図を用いる	kind = 'box'	describe = 'box'
ある <B> を <A> データフレーム中に NaN に置き換えた結果を <A> にする	<A> = <A> . replace ( <B> , np . nan )	nan <A> = <A> . replace ( <B> , np . nan )
データフレーム <A> のカラム <B> とカラム <C> とカラム <D> の箱ひげ図を一枚のグラフで表示する	plt . boxplot ( [ <A> [ <B> ] , <A> [ <C> ] , <A> [ <D> ] ] )	pd . qcut ( <A> [ <B> ] , <C> , label = <D> )
<A> データフレームの中に重複があるのかどうか検出を見る	<A> . duplicated ( )	duplicated <A> . duplicated ( )
<B> データフレーム内に存在する <C> を欠損値にした結果を <A> に代入する	<A> = <B> . replace ( <C> , np . nan )	replace <A> = <B> . replace ( <C> , np . nan )
線の形状は点と線を使う	linestyle = 'dashbot'	markeredgecolor = 'dashbot'
データフレーム <A> 全体をカラム <B> と列 <C> を元に逆順でソートし、再代入する	<A> = <A> . sort_values ( [ <B> , <C> ] , ascending = False )	[ <A> = <A> . sort_values ( [ <B> , <C> ] , ascending = False )
<A> 中の未記入の値を <B> で置き換えた結果で置き換える	<A> . fillna ( <B> , inplace = True )	<B> <A> . fillna ( <B> , inplace = True )
重複があるのかどうかを真偽値で <A> に返す	<A> . duplicated ( )	duplicated <A> . duplicated ( )
表をデータ <B> から読まれた結果を <A> とする	<A> = pd . read_csv ( <B> )	markerfacecolor = pd . read_csv ( <A> , <B> )
<B> データフレーム全体を昇順に <C> コラムでソートし、 <A> に代入する	<A> = <B> . sort_values ( <C> )	markerfacecolor = <B> . sort_values ( <C> )
<A> データフレームの中の未入力の値を <B> で埋めた結果で置き換える	<A> . fillna ( <B> , inplace = True )	<B> <A> . fillna ( <B> , inplace = True )
<A> の中のダブるデータを抽出する	<A> [ <A> . duplicated ( ) ]	duplicated <A> [ <A> . duplicated ( ) ]
<A> の中に未入力の値がどの程度あるのか確認する	<A> . isnull ( ) . sum ( )	isnull <A> . isnull ( ) . sum ( )
<B> 全体をインデックスを軸に小さい順にソートし、 <A> とする	<A> = <B> . sort_index ( )	markerfacecolor = <B> . sort_index ( )
<A> データフレームの未記入の値を <B> にする	<A> . fillna ( <B> )	plt . fillna ( <A> [ <B> ] )
<A> データフレームの <B> を欠損値にされた結果で書き換える	<A> . replace ( <B> , np . nan , inplace = True )	replace <A> . replace ( <B> , np . nan , inplace = True )
<A> データフレームの中の <B> を未入力の値に置き換え未入力の値がある行を取り除く	<A> . replace ( <B> , np . nan ) . dropna ( )	replace <A> . replace ( <B> , np . nan ) . dropna ( )
<B> から <C> にデータフレーム <A> の行の名前をリネームされた結果で置き換える	<A> . rename ( index = { <B> : <C> } , inplace = True )	flush = <A> . rename ( index = { <B> : <C> } , inplace = True )
エクセルファイル <B> の <C> を読み込んでデータフレームに格納した結果を <A> にする	<A> = pd . read_excel ( <B> , sheet_name = <C> )	markerfacecolor = pd . read_excel ( <B> , sheet_name = <C> )
<A> データフレームの <B> を欠損値で埋め、再代入する	<A> = <A> . replace ( <B> , np . nan )	plt . replace ( <A> , <B> , np . nan , inplace = True )
データフレーム <A> 全体をインデックスを元に昇順でソートし、再代入する	<A> = <A> . sort_index ( )	sort_index = <A> . sort_index ( )
<A> の中のの列にある <B> の数	<A> . isin ( [ <B> ] ) . sum ( )	isin <A> . isin ( [ <B> ] ) . sum ( )
<B> データフレームの中の未記入の値を落とした結果を <A> にする	<A> = <B> . dropna ( )	dropna <A> = <B> . dropna ( )
x 軸を <A> とした <B> の鉛直棒グラフを表示する	plt . bar ( <A> , <B> )	<A> = pd . bar ( <B> )
<A> を昇順に <B> でソートし、 <A> とする	<A> = <A> . sort_values ( <B> )	range = <A> . sort_values ( <B> )
<B> 内の欠損値を <C> に置き換えた結果を <A> に代入する	<A> = <B> . fillna ( <C> )	markeredgecolor = <B> . fillna ( <C> )
存在する行を <A> 内の NaN が削除し、置き換える	<A> . dropna ( inplace = True )	dropna = <A> . dropna ( )
データフレーム <A> 内の欠損がある行を削除し、再代入する	<A> = <A> . dropna ( )	marker = <A> . dropna ( )
cRGB で <A> と <B> のグラフを表示する	plt . plot ( <A> , <B> , color = c )	<A> . plt . plot ( <B> , color = c )
データフレーム <A> をカラム <B> と列 <C> を元に逆順でソートした結果で置き換える	<A> = <A> . sort_values ( [ <B> , <C> ] , ascending = False )	flush = <A> . sort_values ( [ <B> , <C> ] , ascending = False , inplace = True )
データフレーム <B> の <C> を欠損で埋めて、 <A> にする	<A> = <B> . replace ( <C> , np . nan )	<B> <A> = <B> . replace ( <C> , np . nan )
タブ区切りでデータ <A> を読み込む	pd . read_csv ( <A> , sep = '\t' )	sep = pd . read_csv ( <A> , sep = '\t' )
区間の数を <C> 、ビンの名前を 0 始まりの連番としてデータフレーム <A> のコラム <B> を分割する	pd . cut ( <A> [ <B> ] , <C> , label = False )	False = pd . cut ( <A> [ <B> ] , <C> , label = False )
エクセルファイル <A> の <B> シート名を読み込み、データフレームにする	pd . read_excel ( <A> , sheet_name = <B> )	sheet_name = <A> . pd . read_excel ( <B> )
柱状グラフを用いる	kind = 'hist'	linestyle = 'hist'
<A> から <B> という名前で CSV ファイルにする	<A> . to_csv ( <B> )	to_csv <A> . to_csv ( <B> )
<A> データを表に格納する	pd . read_csv ( <A> )	kind = pd . read_csv ( <A> )
<A> の中の未記入の値がある行を取り除いて、置き換える	<A> . dropna ( inplace = True )	dropna = <A> . dropna ( )
<A> 内の <B> に重複がある行をドロップした結果を再代入する	<A> = <A> . drop_duplicates ( subset = <B> )	markerfacecolor = <A> . drop_duplicates ( subset = <B> )
<B> 全体をインデックスで順にソートし、 <A> に代入する	<A> = <B> . sort_index ( )	) <A> = <B> . sort_index ( )
ビン数を <D> として <B> データフレームの <C> コラムを分割し、 <A> にする	<A> = pd . cut ( <B> [ <C> ] , <D> )	[ <A> = pd . cut ( <B> [ <C> ] , <D> )
<A> 内に存在する <B> を欠損で補って、再代入する	<A> = <A> . replace ( <B> , np . nan )	nan <A> = <A> . replace ( <B> , np . nan )
表を <B> データからカンマ区切りで読み込んで、 <A> にする	<A> = pd . read_csv ( <B> , sep = ',' )	markerfacecolor = pd . read_csv ( <A> , sep = ',' )
<A> 列に最大表示列数をセットする	pd . set_option ( 'display.max_columns' , <A> )	'display.max_columns' = pd . set_option ( 'display.max_columns' , <A> )
先頭の列をインデックスと設定して、 <A> データをデータフレームとして読み込む	pd . read_csv ( <A> , index_col = 0 )	0 = pd . read_csv ( <A> , index_col = 0 )
<A> 行目までを見れるようにする	pd . set_option ( 'display.max_rows' , <A> )	alpha = pd . set_option ( 'display.max_rows' , <A> )
<B> データフレームの行名を <C> から <D> にリネームし、 <A> にする	<A> = <B> . rename ( index = { <C> : <D> } )	markeredgecolor = <B> . rename ( index = { <C> : <D> } )
データフレーム <B> のコラム <C> の名前を <D> に列 <E> の名前を <F> にリネームして、 <A> に代入する	<A> = <B> . rename ( columns = { <C> : <D> , <E> : <F> } )	<A> = <B> . drop_duplicates ( columns = { <C> : <D> , <E> : <F> } )
先頭の列をインデックスと設定して、 <B> データをデータフレームとして読んで、 <A> に代入する	<A> = pd . read_csv ( <B> , index_col = 0 )	0 = pd . read_csv ( <A> , index_col = 0 )
打点の輪郭の色を黄緑とする	markeredgecolor = 'greenyellow'	color = 'greenyellow'
ある <B> を <A> 中に NaN にして、インプレースする	<A> . replace ( <B> , np . nan , inplace = True )	replace <A> . replace ( <B> , np . nan , inplace = True )
一番左の列をインデックスにセットセットして、 <B> を読み込んだ結果を <A> にする	<A> = pd . read_csv ( <B> , index_col = 0 )	0 = pd . read_csv ( <A> , index_col = 0 )
データフレーム <A> 中のカテゴリ変数をダミー変数化する	pd . get_dummies ( <A> )	get_dummies = pd . get_dummies ( <A> )
ある <B> を <A> 中に NaN に置き換え、 <A> に代入する	<A> = <A> . replace ( <B> , np . nan )	nan <A> = <A> . replace ( <B> , np . nan )
<A> の <B> を未記入の値で置き換えて、 <A> とする	<A> = <A> . replace ( <B> , np . nan )	nan <A> = <A> . replace ( <B> , np . nan )
ある <B> を <A> の中に未記入の値で置き換えて、再代入する	<A> = <A> . replace ( <B> , np . nan )	nan <A> = <A> . replace ( <B> , np . nan )
<A> 内に存在する <B> を欠損で置換し、置き換える	<A> = <A> . replace ( <B> , np . nan )	np . replace ( <A> , <B> , np . nan , inplace = True )
<A> を <B> と <C> で値が大きい順にソートする	<A> . sort_values ( [ <B> , <C> ] , ascending = False )	sort_values <A> . sort_values ( [ <B> , <C> ] , ascending = False )
データフレーム <A> の中の <B> , <C> , <D> 行目の <E> , <C> 列目	<A> . iloc [ [ <B> , <C> , <D> ] , [ <E> , <C> ] ]	pd . cut ( <A> [ <B> ] , <C> , label = <D> )
昇順に <B> データフレーム全体を <C> コラムでソートされた結果を <A> に代入する	<A> = <B> . sort_values ( <C> )	markerfacecolor = <B> . sort_values ( <C> )
エクセルファイル <B> の <C> シート名を読み込み、データフレームにし、 <A> にする	<A> = pd . read_excel ( <B> , sheet_name = <C> )	markerfacecolor = pd . read_excel ( <B> , sheet_name = <C> )
<A> 座標を <A> とした <B> の鉛直棒グラフをグラフ幅を <C> として表示する	plt . bar ( <A> , <B> , width = <C> )	bar plt . bar ( <A> , <B> , width = <C> )
<A> を <B> から <C> の区間の柱状図を用いて表示する	plt . hist ( <A> , range = ( <B> , <C> ) )	<A> = <B> . rename ( columns = { <C> : <D> } )
データフレーム <B> の中の重複要素がある行を落とされた結果を <A> とする	<A> = <B> . drop_duplicates ( )	mode = <B> . drop_duplicates ( )
データフレーム <A> のコラム <B> についての中央値	<A> [ <B> ] . median ( )	plt . boxplot ( <A> [ <B> ] )
色を <A> に変更する	color = <A>	plt . color ( <A> , <B> )
<A> 全体をインデックスを軸に昇順でソートし、再代入する	<A> = <A> . sort_index ( )	markerfacecolor = <A> . sort_index ( )
<B> をインデックスに基づき昇順でソートされた結果を <A> とする	<A> = <B> . sort_index ( )	) <A> = <B> . sort_index ( )
リトルエンディアンを使用する	byteorder = 'little'	start = 'little'
<A> という軸の名前をグラフの x 軸につける	plt . xlabel ( <A> )	pd . xlabel ( <A> )
<A> データフレームを <B> カラムと <C> 列で逆順にソートした結果を <A> に代入する	<A> = <A> . sort_values ( [ <B> , <C> ] , ascending = False )	[ <A> = <A> . sort_values ( [ <B> , <C> ] , ascending = False )
インデックスを元に <A> データフレーム全体を小さい順にソートした結果で置き換える	<A> = <A> . sort_index ( )	kind = <A> . sort_index ( )
データフレーム <B> の中にある <C> を未記入の値に置き換え、 <A> に代入する	<A> = <B> . replace ( <C> , np . nan )	<B> <A> = <B> . replace ( <C> , np . nan )
<A> データフレームの中に重複があるのかどうか判定する	<A> . duplicated ( )	duplicated <A> . duplicated ( )
<A> 中にある <B> を NaN に置き換えられた結果を <A> にする	<A> = <A> . replace ( <B> , np . nan )	nan <A> = <A> . replace ( <B> , np . nan )
<A> に x 軸のラベルを設定する	plt . xlabel ( <A> )	pd . xlabel ( <A> )
データフレーム <A> 中の NaN をデータフレーム <A> の平均値で埋め、置き換える	<A> . fillna ( <A> . mean ( ) , inplace = True )	kind = <A> . fillna ( <A> . mean ( ) )
<A> データフレームの <B> を NaN で置換された結果で置き換える	<A> . replace ( <B> , np . nan , inplace = True )	np . replace ( <A> , <B> , np . nan , inplace = True )
<A> 中の未記入の値がある行を落とされた結果を再代入する	<A> = <A> . dropna ( )	errors = <A> . dropna ( )
左側のデータのインデックスと右側のデータのカラム <C> をキーとしてデータフレーム <A> とデータフレーム <B> をマージする	pd . merge ( <A> , <B> , left_index = True , right_on = <C> )	<A> = pd . merge ( <B> , <C> , left_index = True , right_on = <D> )
データフレーム <B> をインデックスで並び替えて、 <A> とする	<A> = <B> . sort_index ( )	) <A> = <B> . sort_index ( )
エクセルファイル <B> の <C> シート名を読み込んで表に格納し、 <A> にする	<A> = pd . read_excel ( <B> , sheet_name = <C> )	markerfacecolor = pd . read_excel ( <B> , sheet_name = <C> )
データフレーム <A> 内の未入力の値がある行を削除し、再代入する	<A> = <A> . dropna ( )	errors = <A> . dropna ( )
<B> 区切りで <A> データを読み込む	pd . read_csv ( <A> , sep = <B> )	sep = pd . read_csv ( <A> , sep = <B> )
<A> データフレームの中のカテゴリーを one - hot 表現にする	pd . get_dummies ( <A> )	get_dummies = pd . get_dummies ( <A> )
<A> データフレームをエクセルファイル <B> というファイル名で書き込む	<A> . to_excel ( <B> )	markerfacecolor = <A> . to_excel ( <B> )
<A> × <B> に表示するグラフのサイズをする	plt . figure ( figsize = ( <A> , <B> ) )	color = <A> . figure ( figsize = ( <B> ) )
<A> で描画したグラフをセーブする	plt . savefig ( <A> )	kind = <A> . savefig ( <A> )
datetime 型に <A> データフレームの <B> カラムを変換する	pd . to_datetime ( <A> [ <B> ] )	to_datetime = pd . to_datetime ( <A> [ <B> ] )
データフレーム <B> 中のカテゴリーを数値データにした結果を <A> に代入する	<A> = pd . get_dummies ( <B> )	markerfacecolor = pd . get_dummies ( <A> , <B> )
データフレーム <A> 中の欠損を <B> で置き換える	<A> . fillna ( <B> )	plt . fillna ( <A> , <B> )
ダブる最後の行を残して <B> データフレーム中の重複している行を落として、 <A> に代入する	<A> = <B> . drop_duplicates ( keep = False )	markeredgecolor = <B> . drop_duplicates ( keep = False )
透過率を半分にセットする	alpha = 0.5	autopct = 0.5
×の打点を使う	marker = 'x'	linestyle = 'x'
